// Header (IDs beginning with "_" are reserved for header information)
=_LID cs
//
///////////////////////////////////////////////////////////////////////////////////////////////////////////////////
// Global stuff
///////////////////////////////////////////////////////////////////////////////////////////////////////////////////
//
// Dialog (global)
=IDD_DLG_OK(1) 		Potvrdit
=IDD_DLG_CANCEL(1) 	Zrušit
=IDD_DLG_HELP(1) 	&Nápověda
=IDD_DLG_CLOSE(1) 	Zavřít
//
// Resources
=R5(0)				Všechno
//
//
///////////////////////////////////////////////////////////////////////////////////////////////////////////////////
// Lbw global stuff
///////////////////////////////////////////////////////////////////////////////////////////////////////////////////
//
// Dialog
=IDD_LBW_INSNUM(0)	@ Poř.&číslovat
=IDD_LBW_FROM(0)	&Od:
=IDD_LBW_TO(0)		&Do:
=IDD_LBW_FORMAT(0)	&Formát řádku...

// Resources
=LBW_R0(1)			Držitel klíče\nKlíče\nKopie klíče\nVložky\nDveře\nSystém\nAkce\nUmístění\nSkupina vložek\nFunkce vložky\nOddělení\nPřístup\nKalendář
=LBW_R1(0)			Prosím, potvrďte vytvoření %lu %s.
=LBW_R2(0)			Potvrďte úpravy, prosím %lu %s.
=LBW_R3(0)			Potvrďte smazání, prosím %lu %s.
=LBW_R4(0)			Nezadali jste znak pořadí (@) v žádném datovém poli.\rChcete vytvořit identické datové skupiny?
//
// MFC
//
=POPUP0(1)	&Soubor
=POPUP1(1)	*&Archív...
=POPUP2(1)	Odeslat/Přijmout &Soubory
=POPUP3(1)	&Možnosti
=ID_FILE_ARCHIVE_NEW(1)	&Nový...
=ID_FILE_ARCHIVE_OPEN(1)	&Otevřít...
=ID_FILE_NEW(1)	&Nový\tF11
=ID_FILE_OPEN(1)	&Otevřít...\tCtrl+F12
=ID_FILE_B2B_SENDTHIS(1)	&Odeslat aktuální soubor ...
=ID_FILE_B2B_EXCHANGE(1)	&Datová výměna přes internet ...
=ID_FILE_B2B_INBOX(1)	&Doručená pošta ...
=ID_FILE_C2B(1)	&Export Objednávkového programu (C2B)...
=ID_FILE_MRU_FILE1(1)	Naposledy otevřené soubory
=ID_APP_EXIT(1)	U&končit LOCKBASE\tAlt+F4
=ID_OPTIONS_TOOLBAR(1)	&Nástrojová lišta
=ID_OPTIONS_STATUS_BAR(1)	&Stavový řádek
=ID_OPTIONS_LASTFILE(1)	O&tevřít naposledy použitý soubor
=ID_OPTIONS_VIEWS(1)	Otevřít &okno při spuštění...
=ID_OPTIONS_UADMIN(1)	&Uživatelská správa...
=ID_OPTIONS_B2B_AUTOEXCHANGE(1)	&Automatická datová výměna
=ID_OPTIONS_B2B_ADMIN(1)	Správa B2B vizitek...
=ID_OPTIONS_CREATOR(1)	Použít Asistenta &vytvoření
=ID_OPTIONS_CTDBDOC(1)	&Zobraz dokumentaci databáze vložek
=ID_OPTIONS_KEEPPRINTOPEN(1)	Keep print selection open after print
=ID_HELP_INDEX(1)	&Obsah
=ID_HELP_USING(1)	Použití &Nápovědy
=ID_APP_ABOUT(1)	&O LOCKBASE...

=POPUP7(1)	&Upravit
=POPUP8(1)	&Půdorysy
=POPUP9(1)	&Okno
=ID_FILE_ARCHIVE_CLOSE(1)	&Zavřít
=ID_FILE_ARCHIVE_SAVE(1)	&Uložit
=ID_FILE_ARCHIVE_SAVE_AS(1)	Uložit &jako...
=ID_FILE_CLOSE(1)	&Zavřít
=ID_FILE_SAVE(1)	&Uložit\tShift+F12
=ID_FILE_SAVE_AS(1)	Uložit &jako...\tF12
=ID_FILE_SYSTEMINFO(1)	S&ystém Hlavička...
=ID_FILE_READER(1)	Vytvořit &Manager lite...
=ID_FILE_MACHINE(1)	Strojní-&Interface...
=ID_FILE_PRINTSELECTION(1)	&Tisk...\tShift+Ctrl+F12
=ID_EDIT_ADD(1)	&Přidat...\tIns
=ID_EDIT_EDIT(1)	&Upravit...\tReturn
=ID_EDIT_DELETE(1)	&Vymazat\tDel
=ID_EDIT_SORT(1)	&Třídit...
=ID_EDIT_CONNECT(1)	&Spojit...\tF9
=ID_EDIT_KEYRETURN(1)	&Klíče s omezenou platností...
=ID_EDIT_CONSISTENCY(1)	Ko&ntrola bezespornosti...
=ID_EDIT_GROUNDPLAN_ADD(1)	&Přidat...
=ID_EDIT_GROUNDPLAN_EDIT(1)	&Upravit...
=ID_EDIT_GROUNDPLAN_DELETE(1)	&Vymazat
=ID_EDIT_GROUPSELECT(1)	V&ybrat skupinu...\tCtrl+G
=ID_OPTIONS_LISTFONT(1)	Nastavit &písmo...
=ID_OPTIONS_STRINGFORM(1)	&Formát řádku...
=ID_OPTIONS_KEYRETURN(1)	Zobrazení &klíčů s omezenou platností
=ID_WINDOW_CASCADE(1)	Kaská&da
=ID_WINDOW_TILE_HORZ(1)	&Dlaždice
=ID_WINDOW_ARRANGE(1)	&Uspořádat ikony
=ID_WINDOW_STARTLIST(1)	Otevřít Datové &Seznamy\tCtrl+L
=ID_WINDOW_STARTMATRIX(1)	Otevřít Systém &Matrix\tCtrl+S
=ID_WINDOW_STARTCALCULATOR(1)	Otevřít Systém &Kalkulátor\tCtrl+R
=ID_WINDOW_STARTDESIGNER(1)	Otevřít Systém &Návrhář\tCtrl+D
=ID_WINDOW_ACTIVATENEXT(1)	Aktivovat &následující datový sklad\tTab
=ID_WINDOW_ACTIVATEPREV(1)	Aktivovat &předchozí datový sklad\tShift+Tab
=ID_VIEW_SHOWCONNECTED(1)	&Zobrazit spojení
=ID_VIEW_CONNECTEDONLY(1)	Zobrazit pouze &spojené\tF7
=ID_WINDOW_ARRANGELISTS(1)	Aktivní seznam v &plné velikosti\tF8
=ID_VIEW_GROUNDPLAN(1)	Zobrazit &půdorysy


=ID_CALC_CGA(1)			Správa &kódových skupin...\tF3
=ID_CALC_EDITRANGE(1)	Upravit &rozsah frézování klíče...\tF4
=ID_CALC_EDITCODE(1)	Upravit k&ombinace...\tF5
=ID_CALC_CALC(1)		&Počítat
=ID_CALC_TRANSFER(1)	&Přenos dat...
=ID_OPTIONS_FORMATLINES(1)	Formát &řádku...
=ID_OPTIONS_USECGA(1)	&Neumožnit správu kódových skupin

=POPUP10(1)	La&yout...
=ID_EDIT_ADDCOLS(1)		&Přidat (Sloupce)...\tCtrl+Ins
=ID_EDIT_EDITCOLS(1)	&Upravit (Sloupce)...\tCtrl+Return
=ID_EDIT_DELETECOLS(1)	&Vymazat (Sloupce)\tCtrl+Del
=ID_EDIT_COPY_COL(1)	Copy (Colu&mns)\tShift+Ctrl+C
=ID_EDIT_PASTE_COL(1)	&Paste (Columns)\tShift+Ctrl+V
=ID_EDIT_ADDLINES(1)	P&řidat (řádky)...\tIns
=ID_EDIT_EDITLINES(1)	Ed&it (řádky)...\tReturn
=ID_EDIT_DELETELINES(1)	Vy&mazat (řádky)\tDel
=ID_OPTIONS_SYSTEMINFOFONT(1)	Písmo systémových-&informací...
=ID_OPTIONS_FORMATCOLS(1)	Formát &sloupců...
=ID_OPTIONS_FUNCONLY(1)	&Skrýt vložky uzamykané stejně

// Dialog

=IDD_DOOR_EDIT(1)	Dveře
=IDD_DOOR_EDIT_STATICTXT1(1)	&Budova/Oddělení:
=IDD_DOOR_EDIT_STATICTXT2(1)	&Popis dveří:
=IDD_DOOR_EDIT_STATICTXT3(1)	&Název dveří:
=IDD_DOOR_EDIT_STATICTXT4(1)	&Rozměr vložky:
=IDD_DOOR_EDIT_STATICTXT5(1)	P&opis dveří:
=IDD_DOOR_EDIT_STATICTXT6(1)	T&yp:
=IDD_DOOR_EDIT_STATICTXT7(1)	Ro&změry:
=IDD_DOOR_EDIT_STATICTXT8(1)	Pop&is dveří:
=IDD_DOOR_EDIT_STATICTXT9(1)	T&yp:
=IDD_DOOR_EDIT_STATICTXT10(1)	Roz&měry:
=IDD_DOOR_EDIT_OK(1)	Potvrdit
=IDD_DOOR_EDIT_CANCEL(1)	Zrušit
=IDD_DOOR_EDIT_DEFAULT(1)	P&ředvolba
=IDD_DOOR_EDIT_STATICTXT11(1)	První zámek
=IDD_DOOR_EDIT_STATICTXT12(1)	Druhý zámek
=IDD_DOOR_EDIT_HELP(1)	&Nápověda

=IDD_DOORSET_EDIT(1)	Dveře
=IDD_DOORSET_EDIT_STATICTXT1(1)	&Od:
=IDD_DOORSET_EDIT_STATICTXT2(1)	&Do:
=IDD_DOORSET_EDIT_STATICTXT3(1)	&Budova/Oddělení:
=IDD_DOORSET_EDIT_STATICTXT4(1)	&Popis dveří:
=IDD_DOORSET_EDIT_STATICTXT5(1)	&Název dveří:
=IDD_DOORSET_EDIT_STATICTXT6(1)	&Rozměr vložky:
=IDD_DOORSET_EDIT_STATICTXT7(1)	P&opis dveří:
=IDD_DOORSET_EDIT_STATICTXT8(1)	&Typ:
=IDD_DOORSET_EDIT_STATICTXT9(1)	Ro&změry dveří:
=IDD_DOORSET_EDIT_STATICTXT10(1)	Popi&s dveří:
=IDD_DOORSET_EDIT_STATICTXT11(1)	Ty&p:
=IDD_DOORSET_EDIT_STATICTXT12(1)	Ro&změry dveří:
=IDD_DOORSET_EDIT_OK(1)	Potvrdit
=IDD_DOORSET_EDIT_CANCEL(1)	Zrušit
=IDD_DOORSET_EDIT_DEFAULT(1)	&Předvolba
=IDD_DOORSET_EDIT_INSERTNUM(1)	&@ Pořadové číslo
=IDD_DOORSET_EDIT_STATICTXT13(1)	První zámek
=IDD_DOORSET_EDIT_STATICTXT14(1)	Druhý zámek
=IDD_DOORSET_EDIT_HELP(1)	&Nápověda

=IDD_KEYOWNER_EDIT(1)	Držitel klíče
=IDD_KEYOWNER_EDIT_STATICTXT1(1)	Pří&jmení
=IDD_KEYOWNER_EDIT_STATICTXT2(1)	Křestní jm&éno:
=IDD_KEYOWNER_EDIT_STATICTXT3(1)	F&unkce:
=IDD_KEYOWNER_EDIT_STATICTXT4(1)	&Ulice:
=IDD_KEYOWNER_EDIT_STATICTXT5(1)	&Město:
=IDD_KEYOWNER_EDIT_STATICTXT6(1)	Ze&mě:
=IDD_KEYOWNER_EDIT_STATICTXT7(1)	Telefon (&Kancelář):
=IDD_KEYOWNER_EDIT_STATICTXT8(1)	Telefon (&Privát):
=IDD_KEYOWNER_EDIT_STATICTXT9(1)	Osobní &číslo:
=IDD_KEYOWNER_EDIT_STATICTXT10(1)	&Oddělení:
=IDD_KEYOWNER_EDIT_OK(1)	Potvrdit
=IDD_KEYOWNER_EDIT_CANCEL(1)	Zrušit
=IDD_KEYOWNER_EDIT_DEFAULT(1)	Př&edvolba
=IDD_KEYOWNER_EDIT_HELP(1)	&Nápověda

=IDD_DESGN_CYLPATTERN(1)	Šablona vložky
=IDD_DESGN_CYLPATTERN_STATICTXT1(1)	O&značení:
=IDD_DESGN_CYLPATTERN_STATICTXT2(1)	&Typ:
=IDD_DESGN_CYLPATTERN_STATICTXT3(1)	&Rozměr:
=IDD_DESGN_CYLPATTERN_STATICTXT4(1)	&Povrch:
=IDD_DESGN_CYLPATTERN_INSERTNUM(1)	@ Poř.&číslovat
=IDD_DESGN_CYLPATTERN_OK(1)	Potvrdit
=IDD_DESGN_CYLPATTERN_CANCEL(1)	Zrušit
=IDD_DESGN_CYLPATTERN_HELP(1)	&Nápověda

=IDD_DESGN_DOORPATTERN(1)	Šablona dveří
=IDD_DESGN_DOORPATTERN_STATICTXT1(1)	&Budova/Oddělení:
=IDD_DESGN_DOORPATTERN_STATICTXT2(1)	&Popis dveří:
=IDD_DESGN_DOORPATTERN_STATICTXT3(1)	&Název dveří:
=IDD_DESGN_DOORPATTERN_STATICTXT4(1)	&Rozměr vložky:
=IDD_DESGN_DOORPATTERN_STATICTXT5(1)	První zámek
=IDD_DESGN_DOORPATTERN_STATICTXT6(1)	P&opis dveří:
=IDD_DESGN_DOORPATTERN_STATICTXT7(1)	&Typ:
=IDD_DESGN_DOORPATTERN_STATICTXT8(1)	Ro&změr dveří:
=IDD_DESGN_DOORPATTERN_STATICTXT9(1)	Druhý zámek
=IDD_DESGN_DOORPATTERN_STATICTXT10(1)	Pop&is dveří:
=IDD_DESGN_DOORPATTERN_STATICTXT11(1)	T&yp:
=IDD_DESGN_DOORPATTERN_STATICTXT12(1)	Roz&měry dveří:
=IDD_DESGN_DOORPATTERN_INSERTNUM(1)	&@ Poř.číslovat
=IDD_DESGN_DOORPATTERN_OK(1)	Potvrdit
=IDD_DESGN_DOORPATTERN_CANCEL(1)	Zrušit
=IDD_DESGN_DOORPATTERN_HELP(1)	&Nápověda

=IDD_DESGN_KEYPATTERN_STATICTXT1(1)	&Označení klíče:
=IDD_DESGN_KEYPATTERN_STATICTXT2(1)	&Popis klíče:
=IDD_DESGN_KEYPATTERN_STATICTXT3(1)	P&očet klíčů:
=IDD_DESGN_KEYPATTERN_INSERTNUM(1)	&@ Poř.číslovat
=IDD_DESGN_KEYPATTERN_OK(1)	Potvrdit
=IDD_DESGN_KEYPATTERN_CANCEL(1)	Zrušit
=IDD_DESGN_KEYPATTERN_HELP(1)	&Nápověda

=IDD_OPTIONS_VIEWS(1)	Otevřít při spuštění
=IDD_OPTIONS_VIEWS_STATICTXT1(1)	&Zobraz při spuštění:
=IDD_OPTIONS_VIEWS_OK(1)	Potvrdit
=IDD_OPTIONS_VIEWS_CANCEL(1)	Zrušit
=IDD_OPTIONS_VIEWS_HELP(1)	&Nápověda

=IDD_LIST_SEARCHDLG_STATICTXT1(1)	Jdi na:

=IDD_STRINGFORM(1)	Upravit formát řádku %s
=IDD_STRINGFORM_STATICTXT1(1)	&Datová pole:
=IDD_STRINGFORM_STATICTXT2(1)	Upravit
=IDD_STRINGFORM_STATICTXT3(1)	Po&le:
=IDD_STRINGFORM_STATICTXT4(1)	&Pořadí:
=IDD_STRINGFORM_STATICTXT5(1)	&Šířka (mm):
=IDD_STRINGFORM_STRINGFORM_SORTER(1)	&Třídit
=IDD_STRINGFORM_OK(1)	Potvrdit
=IDD_STRINGFORM_CANCEL(1)	Zrušit
=IDD_STRINGFORM_HELP(1)	&Nápověda

=IDD_CHECK_PWD(1)	Ověření hesla
=IDD_CHECK_PWD_STATICTXT1(1)	Vložte heslo k otevření tohoto dokumentu, prosím:
=IDD_CHECK_PWD_OK(1)	Potvrdit

=IDD_PASSWORD(1)	Změnit heslo
=IDD_PASSWORD_STATICTXT1(1)	&Staré heslo:
=IDD_PASSWORD_STATICTXT2(1)	&Nové heslo:
=IDD_PASSWORD_STATICTXT3(1)	&Ověření nového hesla:
=IDD_PASSWORD_OK(1)	Potvrdit
=IDD_PASSWORD_CANCEL(1)	Zrušit

=IDD_DESGN_NEW(1)	Přidat soubor dat|Vložit podskupinu|Sloučit podskupinu
=IDD_DESGN_NEW_DESGN_CHECKHS(1)	&Generální klíč
=IDD_DESGN_NEW_DESGN_BUTTONHS(1)	Upravit (&1)...
=IDD_DESGN_NEW_DESGN_CHECKZ(1)	&Centrální vložka
=IDD_DESGN_NEW_DESGN_BUTTONZ(1)	Upravit (&2)...
=IDD_DESGN_NEW_STATICTXT1(1)	Skupinové &klíče
=IDD_DESGN_NEW_STATICTXT2(1)	&Od:
=IDD_DESGN_NEW_STATICTXT3(1)	&Do:
=IDD_DESGN_NEW_DESGN_BUTTONKS(1)	Upravit (&3)...
=IDD_DESGN_NEW_STATICTXT4(1)	V&ložka
=IDD_DESGN_NEW_STATICTXT5(1)	O&d:
=IDD_DESGN_NEW_STATICTXT6(1)	D&o:
=IDD_DESGN_NEW_DESGN_BUTTONCYL(1)	Upravit (&4)...
=IDD_DESGN_NEW_DESGN_CHECKKEY(1)	&Příslušný klíč
=IDD_DESGN_NEW_DESGN_BUTTONKEY(1)	Upravit (&5)...
=IDD_DESGN_NEW_DESGN_CHECKDOOR(1)	D&veře
=IDD_DESGN_NEW_DESGN_BUTTONDOOR(1)	Upravit (&6)...
=IDD_DESGN_NEW_OK(1)	Potvrdit
=IDD_DESGN_NEW_CANCEL(1)	Zrušit
=IDD_DESGN_NEW_HELP(1)	&Nápověda

=IDD_GRPSELECT(1)	Vybrat skupinu
=IDD_GRPSELECT_OK(1)	Potvrdit
=IDD_GRPSELECT_CANCEL(1)	Zrušit

=LBW_CONNECTIONS(1)				Spojit %s s %s
=LBW_CONNECTIONS_T2(1)			&Spojeno:
=LBW_CONNECTIONS_T3(1)			Spojit s:
=LBW_CONNECTIONS_T4(1)			N&ení spojeno:
=LBW_CONNECTIONS_STRF(1)		Formát &řádku...
=LBW_CONNECTIONS_T1(1)			Spojit:
=LBW_CONNECTIONS_PRINT(1)		&Přímý tisk potvrzení
=LBW_CONNECTIONS_R0(1)			<Hromadný výběr>
=LBW_CONNECTIONS_R1(1)			Spojování datových skupin...
=LBW_CONNECTIONS_R2(1)			Potvrďte nastavení %1 identických spojení datových skupin, prosím

=IDD_CALC_EDITCODE(1)	Upravit kombinace
=IDD_CALC_EDITCODE_STATICTXT1(1)	&Kombinace:
=IDD_CALC_EDITCODE_STATICTXT2(1)	&Profil:
=IDD_CALC_EDITCODE_OK(1)	Potvrdit
=IDD_CALC_EDITCODE_CANCEL(1)	Zrušit
=IDD_CALC_EDITCODE_HELP(1)	&Nápověda
=IDD_CALC_EDITCODE_CHECK_SUSPEND(1)	&Odložit kalkulaci

=IDD_MGL_CREATE(1)	Vytvořit LOCKBASE Manager lite
=IDD_MGL_CREATE_STATICTXT1(1)	Jsou tyto informace platné?
=IDD_MGL_CREATE_STATICTXT2(1)	Číslo &systému:
=IDD_MGL_CREATE_STATICTXT3(1)	&Vlastník:
=IDD_MGL_CREATE_STATICTXT4(1)	Z&ákaznické číslo:
=IDD_MGL_CREATE_STATICTXT5(1)	Licence:
=IDD_MGL_CREATE_STATICTXT6(1)	Vý&robní číslo:
=IDD_MGL_CREATE_STATIC_UNLOCK(1)	&Licenční číslo:
=IDD_MGL_CREATE_OK(1)	Potvrdit
=IDD_MGL_CREATE_CANCEL(1)	Zrušit
=IDD_MGL_CREATE_HELP(1)	&Nápověda

=IDD_CALCULATE_STATICTXT1(1)	&Značka:
=IDD_CALCULATE_BUTTON_SETUP(1)	&Nastavení...
=IDD_CALCULATE_STATIC_CODEGROUP(1)	&Kódová skupina:

=IDD_SETUP_CISA_CHECK_DISPLAY_SP(1)	&Zobrazit boční stavítka
=IDD_SETUP_CISA_STATICTXT2(1)	Pravidla omezení:
=IDD_SETUP_CISA_CHECK_3ALIKE(1)	&Více než tři stejná stavítka v řadě
=IDD_SETUP_CISA_CHECK_2ADJACENT(1)	V&íce než 2 stejná stavítka vedle sebe
=IDD_SETUP_CISA_CHECK_MINDIFF(1)	M&aximální rozdíl menší než 3
=IDD_SETUP_CISA_CHECK_CASCADING(1)	&Sestupné/vzestupné frézování
=IDD_SETUP_CISA_CHECK_ALLOW_MW1(1)	P&ovolit ¨mezistavítko č. 1 na poslední pozici
=IDD_SETUP_CISA_CHECK_MIN_MW2(1)	M&inimální mezistavítko č.2 na všech pozicích
=IDD_SETUP_CISA_STATICTXT4(1)	Konstrukce klíče:
=IDD_SETUP_CISA_CHECK_CKEY(1)	&Zavést konstrukci klíčů
=IDD_SETUP_CISA_STATICTXT5(1)	I&dentifikační šablony:\n(e.g. *,A,B)
=IDD_SETUP_CISA_STATICTXT6(1)	&Množství šablon:\n(e,g. 1,3,1)
=IDD_SETUP_CISA_STATICTXT7(1)	&Ball množství / pozice:\n(např. 2:1,3,4)
=IDD_SETUP_CISA_CHECK_CFILTER(1)	Nedostupné &filtry pro konstrukci klíčů

=IDD_MACHINE(1)	Strojní Interface
=IDD_MACHINE_STATICTXT1(1)		&Stroj typu:
=IDD_MACHINE_STATICTXT2(1)		&Výstupní soubor:
=IDD_MACHINE_STATICTXT3(1)		Rozsah &výstupu:
=IDD_MACHINE_STATICTXT4(1)		&Klíče/Vložky:
=IDD_MACHINE_BUTTON_FILE(1)		Vybrat &Soubor...
=IDD_MACHINE_BUTTON_STRFORM(1)	&Formát řádku...
=IDD_MACHINE_BUTTON_SETUP(1)	&Nastavení...
=IDD_MACHINE_OK(1)	Potvrdit
=IDD_MACHINE_CANCEL(1)			Zrušit
=IDD_MACHINE_HELP(1)			&Nápověda

=IDD_KEYCUTTER_SETUP(1)			Nastavení
=IDD_KEYCUTTER_SETUP_EDIT(0)	&Upravit...

=IDD_DOC_MGLUPDATE(1)	Správce aktualizací systému LOCKBASE
=IDD_DOC_MGLUPDATE_STATIC_MSG(1)	Byla nainstalována aktualizace Vašeho klíčového systému .\nLOCKBASE nyní aktualizuje data systémových souborů.
=IDD_DOC_MGLUPDATE_OK(1)	Start
=IDD_DOC_MGLUPDATE_CANCEL(1)	Zrušit

=IDD_LBW_SITEKEY(1)	LOCKBASE - Licence
=IDD_LBW_SITEKEY_STATICTXT1(1)	&Aktivovace:
=IDD_LBW_SITEKEY_OK(1)	Potvrdit
=IDD_LBW_SITEKEY_CANCEL(1)	Zrušit
=IDD_LBW_SITEKEY_STATICTXT2(1)	K získání platného aktivovacího klíče kontaktujte, prosím, Körtner && Muth GmbH v Hamburgu, Německo:\nTel.: +49-40-430 4436\tFax: +49-40-430 4382\nEMail: lockbase@koertner-muth.com
=IDD_LBW_SITEKEY_STATICTXT3(2)	&Instalace:
=IDD_LBW_SITEKEY_STATIC_INFO(1)	LOCKBASE Verze %s\nLicence %X-%u-%lu-%u
=IDD_LBW_SITEKEY_STATICTXT4(2)	Program nebyl licencován pro tuto pracovní stanici.
=IDD_LBW_SITEKEY_STATICTXT5(1)	Pro spuštění LOCKBASE na tomto počítači musíte zadat odpovídající aktivovací klíč pro číslo instalace zobrazené níže :

=IDD_EVVA_DPIX_OK(1)	Potvrdit
=IDD_EVVA_DPIX_CANCEL(1)	Zrušit
=IDD_EVVA_DPIX_CHECK_MACS(1)	&Změnit MACS z 5 na 6
=IDD_EVVA_DPIX_CHECK_ZERO(1)	&Povolit použití hloubky 0

=IDD_FLIETHER_STATICTXT1(1)	Filtr:
=IDD_FLIETHER_CHECK_3ALIKE(1)	&Povolit více než 3 stejná stavítka
=IDD_FLIETHER_CHECK_2ADJACENT(1)	P&ovolit více než 2 stejná stavítka
=IDD_FLIETHER_CHECK_CASCADING(1)	Pov&olit sestupné/vzestupné frézování
=IDD_FLIETHER_OK(1)	Potvrdit
=IDD_FLIETHER_CANCEL(1)	Zrušit
=IDD_FLIETHER_STATICTXT2(1)	&Maximální rozdíl sousedících frézování
=IDD_FLIETHER_CHECK_USEPIN9(1)	Povolen&o stavítko velikosti 9
=IDD_FLIETHER_CHECK_USEP13P17(1)	&Použít profil 13 a 17
=IDD_FLIETHER_CHECK_USEP10(1)	Použít &profil 10
=IDD_FLIETHER_CHECK_USEALLRIPS(1)	Použít &přímo sousedící profily
=IDD_FLIETHER_STATICTXT3(1)	&Vyplnění centrálně uzamykaných vložek:

=IDD_SETUP_FERTECNO_STATICTXT1(1)	&Volba bubínku:
=IDD_SETUP_FERTECNO_STATICTXT2(1)	1=levý, 2=pravý
=IDD_SETUP_FERTECNO_STATICTXT3(1)	&Bubínek číslo:
=IDD_SETUP_FERTECNO_STATICTXT4(1)	1-9, 0=Test\nDruh profilu (sloupec 2+3) bude nastaven programem LOCKBASE
=IDD_SETUP_FERTECNO_STATICTXT5(1)	vrtání &plochy:
=IDD_SETUP_FERTECNO_STATICTXT6(1)	01-99\t01=3mm 5-stavítko\t05=2mm 5-stavítko\n\t02=3mm 6-stavítko\t06=2mm 6-stavítko\n\t03=2mm 4-stavítko\t07=3mm 6-stavítko\n\t04=2mm 5-stavítko
=IDD_SETUP_FERTECNO_STATICTXT7(1)	&Průměr vrtáku:
=IDD_SETUP_FERTECNO_STATICTXT8(1)	1=9,0 mm, 2=7,1 mm
=IDD_SETUP_FERTECNO_OK(1)	Potvrdit
=IDD_SETUP_FERTECNO_CANCEL(1)	Zrušit
=IDD_SETUP_FERTECNO_STATICTXT9(1)	Tato hodnota může být použita v případě,že nejsou nalezeny žádné vyplněné vstupy v souboru 'FertecnoBohrtabellen.txt'.

=IDD_LISTS_KEYRETURN(1)	Klíče s omezenou platností
=IDD_LISTS_KEYRETURN_STATICTXT1(1)	Byl dosažen nebo překročen termín vrácení následujících klíčů\n :
=IDD_LISTS_KEYRETURN_EDIT_KEY_STRFORM(1)	&Formát...
=IDD_LISTS_KEYRETURN_OK(1)	Potvrdit
=IDD_LISTS_KEYRETURN_HELP(1)	&Nápověda

=IDD_SYSHEAD(1)	Systém Hlavička
=IDD_SYSHEAD_STATIC_TAB1(1)	Hlavička
=IDD_SYSHEAD_STATIC_1(1)	&Číslo systému:
=IDD_SYSHEAD_STATIC_2(1)	&Vlastník:
=IDD_SYSHEAD_STATIC_3(1)	&Zákaznické číslo:
=IDD_SYSHEAD_STATIC_4(1)	&Poznámky:
=IDD_SYSHEAD_CHECK_ALARM(1)	&Zobrazit poznámky při spuštění:
=IDD_SYSHEAD_CHECK_PROTECT_CALC(1)	Ochrana e&xistující kalkulace:
=IDD_SYSHEAD_STATIC_5(1)	D&odavatel:
=IDD_SYSHEAD_STATIC_6(1)	&Typ systému:
=IDD_SYSHEAD_STATIC_7(1)	&Značka:
=IDD_SYSHEAD_STATIC_8(1)	&Datum výroby:
=IDD_SYSHEAD_STATIC_9(1)	&Poslední změny:
=IDD_SYSHEAD_STATIC_20(1)	&Formát Šablony:
=IDD_SYSHEAD_BUTTON_PWD(1)	&Vložit heslo...
=IDD_SYSHEAD_OK(1)	Potvrdit
=IDD_SYSHEAD_CANCEL(1)	Zrušit
=IDD_SYSHEAD_HELP(1)	&Nápověda
=IDD_SYSHEAD_STATIC_TAB2(1)	Historie
=IDD_SYSHEAD_STATIC_10(1)	&Rozšíření:
=IDD_SYSHEAD_STATIC_19(1)	&Poznámky:
=IDD_SYSHEAD_BUTTON_LISTNEW(1)	&Nový
=IDD_SYSHEAD_BUTTON_LISTEDIT(1)	&Upravit...
=IDD_SYSHEAD_BUTTON_LISTDEL(1)	&Vymazat
=IDD_SYSHEAD_BUTTON_LISTORDERS(1)	&Order...
=IDD_SYSHEAD_BUTTON_LISTFORMAT(1)	&Formát...

=IDD_DOC_CONSISTENCY(1)	Kontrola bezespornosti
=IDD_DOC_CONSISTENCY_STATICTXT1(1)	Kontrolovat tyto pravidla:
=IDD_DOC_CONSISTENCY_CHECK1(1)	Neduplikovat &označení klíčů
=IDD_DOC_CONSISTENCY_CHECK2(1)	Neduplikovat &funkce vložek
=IDD_DOC_CONSISTENCY_CHECK3(1)	Neduplikovat &čísla vložek
=IDD_DOC_CONSISTENCY_CHECK4(1)	Příslušný klíč &roven vložce
=IDD_DOC_CONSISTENCY_CHECK5(1)	&Kombinovat vložky uzamykané stejně
=IDD_DOC_CONSISTENCY_STATIC_ERROR(1)	Chyby úplnosti:
=IDD_DOC_CONSISTENCY_STATIC_CURR(1)	Aktuální &hodnota:
=IDD_DOC_CONSISTENCY_STATIC_NEW(1)	Z&měnit na:
=IDD_DOC_CONSISTENCY_BUTTON_IGNORE(1)	&Ignorovat
=IDD_DOC_CONSISTENCY_BUTTON_CORRECT(1)	&Změnit
=IDD_DOC_CONSISTENCY_BUTTON_ABORT(1)	Zr&ušit
=IDD_DOC_CONSISTENCY_OK(1)	Ověřit &nyní
=IDD_DOC_CONSISTENCY_CANCEL(1)	Z&avřít
=IDD_DOC_CONSISTENCY_CHECK9(1)	&Vložky se stejným číslem uzamykané stejně

=IDD_LISTS_GROUNDPLAN(1)	Půdorys
=IDD_LISTS_GROUNDPLAN_STATICTXT1(1)	Zadejte název plánu a vyberte grafický soubor, který půdorys obsahuje (soubor typu BMP, JPG, PNG, TIF, EPS, TGA, PCT, WMF nebo EMF).
=IDD_LISTS_GROUNDPLAN_STATICTXT2(1)	&Název:
=IDD_LISTS_GROUNDPLAN_STATICTXT3(1)	&Grafický soubor:
=IDD_LISTS_GROUNDPLAN_RADIO1(1)	&Vložit půdorys
=IDD_LISTS_GROUNDPLAN_RADIO2(1)	&Sloučit půdorys
=IDD_LISTS_GROUNDPLAN_OK(1)	Potvrdit
=IDD_LISTS_GROUNDPLAN_CANCEL(1)	Zrušit
=IDD_LISTS_GROUNDPLAN_HELP(1)	&Nápověda
=IDD_LISTS_GROUNDPLAN_BUTTON_FILE(1)	&Soubor...

=IDD_LISTS_GROUNDPLAN_ADDITEMS(1)	Přidat dveře do půdorysu
=IDD_LISTS_GROUNDPLAN_ADDITEMS_STATICTXT1(1)	&Dostupné dveře:
=IDD_LISTS_GROUNDPLAN_ADDITEMS_OK(1)	Potvrdit
=IDD_LISTS_GROUNDPLAN_ADDITEMS_CANCEL(1)	Zrušit
=IDD_LISTS_GROUNDPLAN_ADDITEMS_BUTTON_STRFORM(1)	Formát...
=IDD_LISTS_GROUNDPLAN_ADDITEMS_STATICTXT2(1)	Ze seznamu vyberte dveře, které chcete přidat do půdorysu. Poté stiskněte Potvrdit.
=IDD_LISTS_GROUNDPLAN_ADDITEMS_HELP(1)	&Nápověda

=IDD_LISTS_DOORVIEW_STATIC_ZOOM(1)	&Náhled:

=IDD_CISA_MATRIX_SETUP_OK(1)	Potvrdit
=IDD_CISA_MATRIX_SETUP_STATICTXT1(1)	Zadejte dvoumístný CISA zákaznický kód do textového pole níže, prosím.\nTento kód bude použit jako předpona čísla systému generována programem LOCKBASE.
=IDD_CISA_MATRIX_SETUP_STATICTXT2(1)	&Cisa zákaznický kód:
=IDD_CISA_MATRIX_SETUP_CANCEL(1)	Zrušit

=IDD_USERS_LOGIN(1)	LOCKBASE - Inicializace Správy uživatelů|LOCKBASE - Přihlášení|Správa uživatelů - Změna hesla
=IDD_USERS_LOGIN_STATIC1(1)	&Heslo:|&Staré heslo:
=IDD_USERS_LOGIN_STATIC2(1)	&Potvrdit heslo:|&Nové heslo:
=IDD_USERS_LOGIN_STATIC3(1)	&Potvrdit heslo:
=IDD_USERS_LOGIN_OK(1)	Potvrdit
=IDD_USERS_LOGIN_CANCEL(1)	Zrušit
=IDD_USERS_LOGIN_HELP(1)	&Nápověda
=IDD_USERS_LOGIN_STATIC_INSTRUCT(1)	Pokyny
=IDD_USERS_LOGIN_STATICTXT1(1)	&Uživatelské jméno:

=IDD_USERS_ADMIN(1)	Správa uživatelů
=IDD_USERS_ADMIN_STATICTXT1(1)	Seznam &Uživatelů:
=IDD_USERS_ADMIN_BUTTON_NEW(1)	&Nový
=IDD_USERS_ADMIN_BUTTON_REM(1)	Od&stranit
=IDD_USERS_ADMIN_STATICTXT2(1)	Nastavení:
=IDD_USERS_ADMIN_STATICTXT3(1)	&Uživatelské jméno:
=IDD_USERS_ADMIN_CHECK_ADMIN(1)	&Správce:
=IDD_USERS_ADMIN_CHECK_OSLOGIN(1)	Přijmout přihlášení do &Windows:
=IDD_USERS_ADMIN_STATICTXT4(1)	&Heslo:
=IDD_USERS_ADMIN_STATICTXT5(1)	P&otvrdit heslo:
=IDD_USERS_ADMIN_STATICTXT6(1)	&Oprávnění:
=IDD_USERS_ADMIN_OK(1)	Zavřít
=IDD_USERS_ADMIN_BUTTON_DISABLE(1)	&Zakázat
=IDD_USERS_ADMIN_HELP(1)	&Nápověda

=IDD_ABOUTBOX(1)	O LOCKBASE
=IDD_ABOUTBOX_STATICTXT1(1)	Licence:
=IDD_ABOUTBOX_STATIC_ABOUT(1)	LOCKBASE Verze %s\nLicenční číslo %X-%u-%lu-%u
=IDD_ABOUTBOX_STATICTXT2(1)	Copyright:
=IDD_ABOUTBOX_STATICTXT4(1)	Aktualizace přes Web:
=IDD_ABOUTBOX_CHECK_AUTO(1)	Prověřit aktualizace &Vždy automaticky
=IDD_ABOUTBOX_STATICTXT5(1)	&Dny
=IDD_ABOUTBOX_STATICTXT6(1)	&Heslo podpory:
=IDD_ABOUTBOX_BUTTON_UPDATE(1)	&Prověřit nyní...
=IDD_ABOUTBOX_STATICTXT7(1)	Vytvořeno:
=IDD_ABOUTBOX_OK(1)	Potvrdit
=IDD_ABOUTBOX_CANCEL(1)	Zrušit
=IDD_ABOUTBOX_HELP(1)	&Nápověda

=IDD_UPDATE(1)	LOCKBASE servis aktualizací
=IDD_UPDATE_CANCEL(1)	Zrušit
=IDD_UPDATE_OK(1)	Další >>
=IDD_UPDATE_HELP(1)	&Nápověda

=IDD_DOC_FILESEARCH_STATICTXT1(1)	&Obsahuje:
=IDD_DOC_FILESEARCH_BUTTON_SEARCH(1)	V&yhledat...
=IDD_DOC_FILESEARCH_STATICTXT2(1)	&Heslo:
=IDD_DOC_FILESEARCH_HELP(1)	&Nápověda
=IDD_DOC_FILESEARCH_STATICTXT3(1)	&Výsledky Vyhledávání:
=IDD_DOC_FILESEARCH_STATIC_COVER(1)	N&áhled:

=IDD_CALC_TRANSFER(1)	Přenos kalkulace
=IDD_CALC_TRANSFER_RADIO_IMPORT(1)	&Import
=IDD_CALC_TRANSFER_RADIO_CHGLOG(1)	&Hlášení změn
=IDD_CALC_TRANSFER_RADIO_EXPORT(1)	&Export
=IDD_CALC_TRANSFER_OK(1)	Potvrdit
=IDD_CALC_TRANSFER_CANCEL(1)	Zrušit
=IDD_CALC_TRANSFER_HELP(1)	&Nápověda

=IDD_CALC_SETUP(1)	DIN-CZ Filtr Nastavení
=IDD_CALC_SETUP_STATICTXT1(1)	&Maximální celkový počet\nstejných frézování:
=IDD_CALC_SETUP_STATICTXT2(1)	M&aximální počet\n stejných frézování vedle sebe:
=IDD_CALC_SETUP_STATICTXT3(1)	Ma&ximální rozdíl\nsousedících frézování (MACS):
=IDD_CALC_SETUP_STATICTXT4(1)	M&inimální rozdíl mezi\nnejhlubším a nejmělčím frézováním:
=IDD_CALC_SETUP_CHECK_CASCADE(1)	&Povolit sestupné/vzestupné frézování:
=IDD_CALC_SETUP_OK(1)	Potvrdit
=IDD_CALC_SETUP_CANCEL(1)	Zrušit
=IDD_CALC_SETUP_BUTTON_RESET(1)	&Vynulovat

=IDD_KEYSET_EDIT(1)	Funkce klíče
=IDD_KEYSET_EDIT_STATICTXT1(1)	&Od:
=IDD_KEYSET_EDIT_STATICTXT2(1)	&Do:
=IDD_KEYSET_EDIT_STATICTXT3(1)	O&značení:
=IDD_KEYSET_EDIT_STATICTXT4(1)	P&opis klíče:
=IDD_KEYSET_EDIT_STATICTXT5(1)	T&yp:
=IDD_KEYSET_EDIT_STATIC_NUMBEROFKEYS(1)	Počet &klíčů:
=IDD_KEYSET_EDIT_STATIC_CODEGROUP(1)	Kódová &skupina:
=IDD_KEYSET_EDIT_STATIC_COMBINATION(1)	&Kombinace:
=IDD_KEYSET_EDIT_STATIC_PROFILE(1)	&Profil:
=IDD_KEYSET_EDIT_OK(1)	Potvrdit
=IDD_KEYSET_EDIT_CANCEL(1)	Zrušit
=IDD_KEYSET_EDIT_DEFAULT(1)	&Předvolba
=IDD_KEYSET_EDIT_INSERTNUM(1)	@ Poř.&číslovat
=IDD_KEYSET_EDIT_HELP(1)	&Nápověda

=IDD_KEYFUNC_EDIT(1)	Funkce klíče
=IDD_KEYFUNC_EDIT_STATICTXT1(1)	&Označení:
=IDD_KEYFUNC_EDIT_STATICTXT2(1)	Po&pis klíče:
=IDD_KEYFUNC_EDIT_STATICTXT3(1)	T&yp:
=IDD_KEYFUNC_EDIT_STATIC_NUMBEROFKEYS(1)	P&očet klíčů:
=IDD_KEYFUNC_EDIT_STATIC_KEY_ANGLE(1)	Kódová &skupina:
=IDD_KEYFUNC_EDIT_STATIC_KEY_COMBINATION(1)	&Kombinace:
=IDD_KEYFUNC_EDIT_STATIC_KEY_PROFILE(1)	&Profil:
=IDD_KEYFUNC_EDIT_STATIC_KEYS(1)	&Klíče:
=IDD_KEYFUNC_EDIT_BUTTON_LISTADD(1)	&Nový klíč
=IDD_KEYFUNC_EDIT_BUTTON_LISTEDIT(1)	&Upravit klíč...
=IDD_KEYFUNC_EDIT_BUTTON_LISTDEL(1)	&Vymazat klíč
=IDD_KEYFUNC_EDIT_OK(1)	Potvrdit
=IDD_KEYFUNC_EDIT_CANCEL(1)	Zrušit
=IDD_KEYFUNC_EDIT_HELP(1)	&Nápověda
=IDD_KEYFUNC_EDIT_BUTTON_LISTFORMAT(1)	&Formát řádku...
=IDD_KEYFUNC_EDIT_STATIC_KEY_USAGE(1)	Užívání: %s

=LBW_KEYFUNC(1)	Funkce klíče
=LBW_KEYFUNC_STATICTXT1(1)	O&značení:
=LBW_KEYFUNC_STATICTXT2(1)	&Popis klíče:
=LBW_KEYFUNC_STATICTXT3(1)	T&yp:
=LBW_KEYFUNC_STATIC_NUMBEROFKEYS(1)	Po&čet klíčů:
=LBW_KEYFUNC_STATIC5(1)	&Kódová skupina:
=LBW_KEYFUNC_STATIC6(1)	Ko&mbinace:
=LBW_KEYFUNC_STATIC7(1)	&Profil:
=LBW_KEYFUNC_STATIC_KEYS(1)	K&líče:
=LBW_KEYFUNC_BUTTON_LISTADD(1)	No&vý klíč
=LBW_KEYFUNC_BUTTON_LISTEDIT(1)	&Upravit klíč...
=LBW_KEYFUNC_BUTTON_LISTDEL(1)	&Vymazat klíč
=LBW_KEYFUNC_STATIC_KEY_USAGE(1)	Užívání: %s

=IDD_CALC_ANKER38_CHECK1(1)	&Použít dvojitý magnet na klíčích
=IDD_CALC_ANKER38_STATICTXT1(1)	&Způsob kalkulace:
=IDD_CALC_ANKER38_OK(1)	Potvrdit
=IDD_CALC_ANKER38_CANCEL(1)	Zrušit

=IDD_PRINT_FORMAT(1)	Formát
=IDD_PRINT_FORMAT_TAB_FORM(1)	Tiskopis
=IDD_PRINT_FORMAT_STATIC_100(1)	&Název:
=IDD_PRINT_FORMAT_STATIC_101(1)	&Záhlaví:
=IDD_PRINT_FORMAT_STATIC_102(1)	&Podtitul:
=IDD_PRINT_FORMAT_STATIC_103(1)	&Zápatí:
=IDD_PRINT_FORMAT_STATIC_105(1)	&Logo:
=IDD_PRINT_FORMAT_STATIC_106(1)	T&iskopis ze souboru:
=IDD_PRINT_FORMAT_TAB_MARGINS(1)	Okraje
=IDD_PRINT_FORMAT_STATIC_200(1)	&Levý:
=IDD_PRINT_FORMAT_STATIC_205(1)	mm
=IDD_PRINT_FORMAT_STATIC_201(1)	&Nahoře:
=IDD_PRINT_FORMAT_STATIC_206(1)	mm
=IDD_PRINT_FORMAT_STATIC_202(1)	&Pravý:
=IDD_PRINT_FORMAT_STATIC_207(1)	mm
=IDD_PRINT_FORMAT_STATIC_204(1)	&Dole:
=IDD_PRINT_FORMAT_STATIC_208(1)	mm
=IDD_PRINT_FORMAT_TAB_PRINTER(1)	Tiskárna
=IDD_PRINT_FORMAT_STATIC_104(1)	&Tiskárna:
=IDD_PRINT_FORMAT_STATIC_107(1)	V&elikost papíru:
=IDD_PRINT_FORMAT_STATIC_108(1)	Zdroj &papíru:
=IDD_PRINT_FORMAT_STATIC_109(1)	&Orientace:
=IDD_PRINT_FORMAT_STATIC_110(1)	Kvalita &tisku:
=IDD_PRINT_FORMAT_TAB_DATASTOCKS(1)	Datové Sklady
=IDD_PRINT_FORMAT_STATIC_300(1)	&Primární datový sklad:
=IDD_PRINT_FORMAT_STATIC_301(1)	&Sekundární datový sklad:
=IDD_PRINT_FORMAT_STATIC_302(1)	&Terciární datový sklad:
=IDD_PRINT_FORMAT_TAB_FONTFORM(1)	Písmo a formát řádku
=IDD_PRINT_FORMAT_STATIC_400(1)	&Písmo:
=IDD_PRINT_FORMAT_BUTTON_FONT(1)	&Upravit...
=IDD_PRINT_FORMAT_STATIC_401(1)	&Formát řádku:
=IDD_PRINT_FORMAT_BUTTON_FORM(1)	U&pravit...
=IDD_PRINT_FORMAT_TAB_TEXT(1)	Texty
=IDD_PRINT_FORMAT_STATIC_500(1)	&Popis dveří:
=IDD_PRINT_FORMAT_STATIC_501(1)	&Obsah:
=IDD_PRINT_FORMAT_TAB_OPTIONS(1)	Nastavení
=IDD_PRINT_FORMAT_TAB_LABEL(1)	Rozvržení
=IDD_PRINT_FORMAT_STATIC_700(1)	Označení okrajů:
=IDD_PRINT_FORMAT_STATIC_701(1)	&Levý:
=IDD_PRINT_FORMAT_STATIC_MM1(1)	mm
=IDD_PRINT_FORMAT_STATIC_702(1)	&Nahoře:
=IDD_PRINT_FORMAT_STATIC_MM2(1)	mm
=IDD_PRINT_FORMAT_STATIC_703(1)	&Pravý:
=IDD_PRINT_FORMAT_STATIC_MM3(1)	mm
=IDD_PRINT_FORMAT_STATIC_704(1)	&Dole:
=IDD_PRINT_FORMAT_STATIC_MM4(1)	mm
=IDD_PRINT_FORMAT_STATIC_705(1)	Rozvržení:
=IDD_PRINT_FORMAT_STATIC_706(1)	&Vodorovně:
=IDD_PRINT_FORMAT_STATIC_708(1)	&Svisle:
=IDD_PRINT_FORMAT_STATIC_709(1)	Textové &Úpravy:
=IDD_PRINT_FORMAT_CHECK_DESC(1)	&Popis datových polí
=IDD_PRINT_FORMAT_STATIC_711(1)	&Šířka:
=IDD_PRINT_FORMAT_STATIC_712(1)	mm
=IDD_PRINT_FORMAT_CHECK_EVALQTY(1)	&Evaluate 'Quantity'
=IDD_PRINT_FORMAT_OK(1)	Potvrdit
=IDD_PRINT_FORMAT_CANCEL(1)	Zrušit
=IDD_PRINT_FORMAT_HELP(1)	&Nápověda
=IDD_PRINT_FORMAT_STATIC_710(1)	Možnosti:
=IDD_PRINT_FORMAT_STATIC_111(1)	&Kopie:

=IDD_PRINT_SELECT(1)	Co má být vytištěno?
=IDD_PRINT_SELECT_STATICTXT1(1)	&Tiskopisy:
=IDD_PRINT_SELECT_STATICTXT2(1)	Ti&skárna:
=IDD_PRINT_SELECT_STATICTXT3(1)	&Rozsah výstupu:
=IDD_PRINT_SELECT_STATICTXT4(1)	&Datové soubory:
=IDD_PRINT_SELECT_TAB_LABELS(1)	Spustit adresu tiskárny
=IDD_PRINT_SELECT_STATIC1(1)	&Řádek:
=IDD_PRINT_SELECT_STATIC2(1)	Slo&upec:
=IDD_PRINT_SELECT_CANCEL(1)	Zavřít
=IDD_PRINT_SELECT_OK(1)	&Tisk
=IDD_PRINT_SELECT_BUTTON_PREVIEW(1)	Náh&led
=IDD_PRINT_SELECT_BUTTON_FORMAT(1)	For&mát...
=IDD_PRINT_SELECT_BUTTON_COPY(1)	&Kopírovat
=IDD_PRINT_SELECT_BUTTON_REMOVE(1)	&Odstranit
=IDD_PRINT_SELECT_HELP(1)	&Nápověda

=IDD_CYLINDER_CTDB_EXTRA(1)	Zvláštní úpravy
=IDD_CYLINDER_CTDB_EXTRA_LIST_MAIN(1)	Krátký popis\tPopis
=IDD_CYLINDER_CTDB_EXTRA_STATICTXT1(1)	Stiskněte <CTRL> pro vícenásobný výběr
=IDD_CYLINDER_CTDB_EXTRA_STATIC_HELP(1)	Tato možnost musí být specifikována více detailně. Vyberte jednu z hodnot níže:
=IDD_CYLINDER_CTDB_EXTRA_LIST_ATTR(1)	Hodnota\tpopis
=IDD_CYLINDER_CTDB_EXTRA_OK(1)	Potvrdit

=IDD_DOC_SORT(1)	Třídit
=IDD_DOC_SORT_STATICTXT1(1)	&Datové sklady:
=IDD_DOC_SORT_STATICTXT2(1)	Třídit dle:
=IDD_DOC_SORT_STATICTXT3(1)	&Primárního datového pole:
=IDD_DOC_SORT_STATICTXT4(1)	&Sekundárního datového pole:
=IDD_DOC_SORT_STATICTXT5(1)	Rozsah:
=IDD_DOC_SORT_RADIO_SEL(1)	V&ýběr
=IDD_DOC_SORT_RADIO_ALL(1)	&Vše
=IDD_DOC_SORT_STATICTXT6(1)	Způsob:
=IDD_DOC_SORT_RADIO_ASC(1)	V&zestupně
=IDD_DOC_SORT_RADIO_DESC(1)	S&estupně
=IDD_DOC_SORT_OK(1)	&Třídit
=IDD_DOC_SORT_CANCEL(1)	Zrušit
=IDD_DOC_SORT_HELP(1)	&Nápověda
=IDD_DOC_SORT_STATICTXT7(1)	Provádíte změny v pořadí datových skupin v nesetříděném zobrazovacím módu. Tyto změny nelze vzít zpět!

=IDD_DESGN_VIEW_DESGN_STATISTIC(1)	Statistiky:
=IDD_DESGN_VIEW_STATICTXT1(1)	Skupina:
=IDD_DESGN_VIEW_STATICTXT2(1)	Relativní velikost:
=IDD_DESGN_VIEW_STATICTXT3(1)	Počet funkcí klíčů:
=IDD_DESGN_VIEW_STATICTXT4(1)	Počet funkcí vložek:
=IDD_DESGN_VIEW_STATICTXT5(1)	Počet vložek:
=IDD_DESGN_VIEW_STATICTXT6(1)	Počet skupinových klíčů:
=IDD_DESGN_VIEW_STATICTXT7(1)	Podíl skupinových klíčů:
=IDD_DESGN_VIEW_DESGN_SUBGROUPAREA(1)	&Podskupiny:
=IDD_DESGN_VIEW_DESGN_ADDSUBGRP(1)	P&řipojit...
=IDD_DESGN_VIEW_DESGN_INSSUBGRP(1)	&Vložit...
=IDD_DESGN_VIEW_DESGN_MULTIPLY(1)	V&íce násobný...
=IDD_DESGN_VIEW_DESGN_MERGESUBGRP(1)	&Sloučit
=IDD_DESGN_VIEW_DESGN_ANALYSE(1)	&Analyzovat
=IDD_DESGN_VIEW_DESGN_EDGROUPAREA(1)	Skupinová &data:
=IDD_DESGN_VIEW_STATICTXT8(1)	&Název:
=IDD_DESGN_VIEW_DESGN_CHECKHS(1)	Ge&nerální klíč
=IDD_DESGN_VIEW_DESGN_BUTTONHS(1)	&GK...
=IDD_DESGN_VIEW_DESGN_CHECKZ(1)	C&entrální vložka
=IDD_DESGN_VIEW_DESGN_BUTTONZ(1)	M&C...
=IDD_DESGN_VIEW_DESGN_ADDDATA(1)	Přida&t soubory dat...
=IDD_DESGN_VIEW_DESGN_REMGRP(1)	V&ymazat
=IDD_DESGN_VIEW_STATICTXT9(1)	S&kupinové klíče:
=IDD_DESGN_VIEW_DESGN_CONNECT(1)	S&pojit...

=IDD_DESGN_MULTIPLY(1)	Násobit podskupinu
=IDD_DESGN_MULTIPLY_STATICTXT1(1)	Číslování skupin:
=IDD_DESGN_MULTIPLY_STATICTXT2(1)	&Od:
=IDD_DESGN_MULTIPLY_STATICTXT3(1)	&Do:
=IDD_DESGN_MULTIPLY_STATICTXT4(1)	Nahrazení textu:
=IDD_DESGN_MULTIPLY_STATICTXT5(1)	&Nahradit:
=IDD_DESGN_MULTIPLY_STATICTXT6(1)	&Čím:
=IDD_DESGN_MULTIPLY_STATICTXT7(1)	&a:
=IDD_DESGN_MULTIPLY_STATICTXT8(1)	Č&ím:
=IDD_DESGN_MULTIPLY_OK(1)	Potvrdit
=IDD_DESGN_MULTIPLY_CANCEL(1)	Zrušit
=IDD_DESGN_MULTIPLY_HELP(1)	&Nápověda
=IDD_DESGN_MULTIPLY_INSERTNUM(1)	&@ Poř.číslovat
=IDD_DESGN_MULTIPLY_STATICTXT9(1)	Varování: Podskupiny sloužící jako šablony budou zahrnuty do číslování a také budou předmětem nahrazení textu.

=IDD_EXCHG_CSVSELECT(1)	Vybrat upřesňující formát
=IDD_EXCHG_CSVSELECT_STATICTXT1(1)	Vybrat formát dat, který může být použit k převádění obsahů tabulek. Definujte nový, pokud není vhodný formát specifikací dostupný.
=IDD_EXCHG_CSVSELECT_LIST1(1)	Název\tpopis
=IDD_EXCHG_CSVSELECT_OK(1)	Aplikovat
=IDD_EXCHG_CSVSELECT_CANCEL(1)	Zavřít
=IDD_EXCHG_CSVSELECT_HELP(1)	&Nápověda
=IDD_EXCHG_CSVSELECT_BUTTON1(1)	N&ový
=IDD_EXCHG_CSVSELECT_BUTTON2(1)	&Upravit
=IDD_EXCHG_CSVSELECT_BUTTON3(1)	&Vymazat
=IDD_EXCHG_CSVSELECT_BUTTON4(1)	&Kopírovat
=IDD_EXCHG_CSVSELECT_BUTTON5(1)	Vlo&žit

=IDD_EXCHG_CSVEDIT(1)	Upravit upřesňujíc formát
=IDD_EXCHG_CSVEDIT_STATICTXT1(1)	&Název:
=IDD_EXCHG_CSVEDIT_STATICTXT2(1)	&Popis:
=IDD_EXCHG_CSVEDIT_STATICTXT3(1)	Upřesňující formát specifikací
=IDD_EXCHG_CSVEDIT_STATICTXT4(1)	Odd&ělovač polí:
=IDD_EXCHG_CSVEDIT_STATICTXT5(1)	Oddělovač te&xtu:
=IDD_EXCHG_CSVEDIT_STATICTXT6(1)	Dato&vá pole:
=IDD_EXCHG_CSVEDIT_BUTTON1(1)	Nov&ý
=IDD_EXCHG_CSVEDIT_BUTTON2(1)	Vy&mazat
=IDD_EXCHG_CSVEDIT_STATICTXT7(1)	Datové pole
=IDD_EXCHG_CSVEDIT_STATICTXT8(1)	&Typ zdrojových dat:
=IDD_EXCHG_CSVEDIT_STATICTXT9(1)	T&yp dat:
=IDD_EXCHG_CSVEDIT_STATICTXT10(1)	D&atové pole:
=IDD_EXCHG_CSVEDIT_STATICTXT11(1)	Ta&bulka:
=IDD_EXCHG_CSVEDIT_STATICTXT12(1)	O&blast zdroje:
=IDD_EXCHG_CSVEDIT_STATICTXT13(1)	&Od:
=IDD_EXCHG_CSVEDIT_STATICTXT14(1)	&Do:
=IDD_EXCHG_CSVEDIT_STATICTXT15(1)	Spojení
=IDD_EXCHG_CSVEDIT_STATICTXT16(1)	Typ spo&jení:
=IDD_EXCHG_CSVEDIT_STATICTXT17(1)	&Cílový typ dat:
=IDD_EXCHG_CSVEDIT_STATICTXT18(1)	Cí&lové pole dat:
=IDD_EXCHG_CSVEDIT_STATICTXT19(1)	Obla&st zdroje:
=IDD_EXCHG_CSVEDIT_STATICTXT20(1)	&Od:
=IDD_EXCHG_CSVEDIT_STATICTXT21(1)	&Do:
=IDD_EXCHG_CSVEDIT_OK(1)	Potvrdit
=IDD_EXCHG_CSVEDIT_CANCEL(1)	Zrušit
=IDD_EXCHG_CSVEDIT_HELP(1)	&Nápověda

=IDD_KEY_EDIT(1)	Klíč
=IDD_KEY_EDIT_STATICTXT1(1)	&Ražba:
=IDD_KEY_EDIT_STATICTXT2(1)	&Electronic ID:
=IDD_KEY_EDIT_STATICTXT3(1)	D&atum výroby:
=IDD_KEY_EDIT_STATICTXT4(1)	Da&tum výdeje:
=IDD_KEY_EDIT_STATICTXT5(1)	Dat&um příjmu:
=IDD_KEY_EDIT_STATICTXT6(1)	&Stav:
=IDD_KEY_EDIT_STATICTXT7(1)	&Poznámky:
=IDD_KEY_EDIT_STATICTXT8(1)	&Držitel klíče:
=IDD_KEY_EDIT_OK(1)	Potvrdit
=IDD_KEY_EDIT_CANCEL(1)	Zrušit
=IDD_KEY_EDIT_HELP(1)	&Nápověda

=IDD_DOC_SEARCH(1)	Vyhledávání
=IDD_DOC_SEARCH_STATICTXT1(1)	&Najít:
=IDD_DOC_SEARCH_STATICTXT2(1)	&Datové pole:
=IDD_DOC_SEARCH_OK(1)	Vyhledat
=IDD_DOC_SEARCH_CANCEL(1)	Zrušit

=IDD_DOC_SEARCH_EX(1)	Vyhledávání
=IDD_DOC_SEARCH_EX_STATICTXT1(1)	Zadejte výraz, který chcete vyhledat. Při použití různých slov, budou tato kombinovány logicky (čímž dojde ke snížení počtu nalezených).
=IDD_DOC_SEARCH_EX_STATICTXT2(1)	&Najít:
=IDD_DOC_SEARCH_EX_STATICTXT3(1)	&Datový sklad:
=IDD_DOC_SEARCH_EX_STATICTXT4(1)	Datové &pole:
=IDD_DOC_SEARCH_EX_STATICTXT5(1)	&Akce:
=IDD_DOC_SEARCH_EX_OK(1)	Vyhledat
=IDD_DOC_SEARCH_EX_CANCEL(1)	Zrušit

=IDD_CYLINDER(1)	Vložka
=IDD_CYLINDER_STATICTXT1(1)	&Od:
=IDD_CYLINDER_STATICTXT2(1)	&Do:
=IDD_CYLINDER_STATICTXT3(1)	Vložka
=IDD_CYLINDER_STATICTXT4(1)	Ozna&eení:
=IDD_CYLINDER_STATICTXT5(1)	&Item code:
=IDD_CYLINDER_STATICTXT6(1)	T&yp:
=IDD_CYLINDER_STATICTXT7(1)	&Zvláštní úpravy:
=IDD_CYLINDER_BUTTON_EXTRAS(1)	319
=IDD_CYLINDER_STATICTXT8(1)	D&élka vnijší:
=IDD_CYLINDER_STATICTXT9(1)	&Vnitoní:
=IDD_CYLINDER_STATICTXT10(1)	Pov&rch:
=IDD_CYLINDER_STATICTXT11(1)	Poe&et:
=IDD_CYLINDER_CHECK_SUPER(1)	&Centrální vložka:
=IDD_CYLINDER_CHECK_KEYS(1)	P&oíslušný klíe:
=IDD_CYLINDER_STATIC_N_KEYS(1)	Kop&ií
=IDD_CYLINDER_BUTTON_EDITKEY(1)	&Upravit...
=IDD_CYLINDER_STATICTXT15(1)	Budova/Oddilení:
=IDD_CYLINDER_STATICTXT16(1)	Popi&s Dveoí:
=IDD_CYLINDER_STATICTXT17(1)	Oddi&lení:
=IDD_CYLINDER_STATICTXT18(1)	Poslední z&miny:
=IDD_CYLINDER_INSERTNUM(1)	&@ Poo.eíslovat
=IDD_CYLINDER_DEFAULT(1)	&Poedvolba
=IDD_CYLINDER_HELP(1)	&Nápovida
=IDD_CYLINDER_CANCEL(1)	Zrušit
=IDD_CYLINDER_OK(1)	Potvrdit
=IDD_CYLINDER_STATIC_1(1)	K&ódová Skupina:
=IDD_CYLINDER_STATIC_2(1)	Pro&fil:
=IDD_CYLINDER_STATIC_3(1)	&Bubínek:
=IDD_CYLINDER_STATIC_4(1)	Ob&al:

=IDD_CALCEDIT(1)	Upravit rozsah frézování klíče
=IDD_CALCEDIT_STATICTXT1(1)	Skupina:\nRelativní velikost:\nFunkce klíčů:\nFunkce vložek:\nSkupinové klíče:\nDávka skupinových klíčů:
=IDD_CALCEDIT_STATICTXT2(1)	&Rozsah frézování klíče:
=IDD_CALCEDIT_STATIC_KEYPROFLIST(1)	Profily &klíčů:
=IDD_CALCEDIT_STATIC_CYLPROFLIST(1)	Profily &bubínků:
=IDD_CALCEDIT_CHECK_ROTATING(1)	&Použít otočné konstanty
=IDD_CALCEDIT_STATIC_ROTATING(1)	P&ozice
=IDD_CALCEDIT_CHECK_RANDOM(1)	K&alkulovat příslušné klíče v náhodném pořadí
=IDD_CALCEDIT_OK(1)	Potvrdit
=IDD_CALCEDIT_CANCEL(1)	Zrušit
=IDD_CALCEDIT_HELP(1)	&Nápověda
=IDD_CALCEDIT_BUTTON_HS(1)	&Generální klíč
=IDD_CALCEDIT_BUTTON_EXCL(1)	&Exkluzivita

=IDD_CFG_LOADFORMAT_STATICTXT2(1)	&Dodavatel:
=IDD_CFG_LOADFORMAT_STATICTXT3(1)	&Typ systému:
=IDD_CFG_LOADFORMAT_STATICTXT4(1)	Z&načka:
=IDD_CFG_LOADFORMAT_STATICTXT5(1)	&Poznámky:
=IDD_CFG_LOADFORMAT_STATICTXT6(1)	&Zobrazit poznámky při spuštění:
=IDD_CFG_LOADFORMAT_STATICTXT7(1)	&Ochrana existující kalkulace:
=IDD_CFG_LOADFORMAT_OK(1)	Potvrdit
=IDD_CFG_LOADFORMAT_CANCEL(1)	Zrušit
=IDD_CFG_LOADFORMAT_HELP(1)	&Nápověda

=AFX_IDD_NEWTYPEDLG(1)	Nový
=AFX_IDD_NEWTYPEDLG_STATICTXT1(1)	&Nový 
=AFX_IDD_NEWTYPEDLG_OK(1)	OK
=AFX_IDD_NEWTYPEDLG_CANCEL(1)	Zrušit
=AFX_IDD_NEWTYPEDLG_HELP(1)	&Pomoc

=AFX_IDD_PRINTDLG_STATICTXT1(1)	Probíhá tisk
=AFX_IDD_PRINTDLG_STATICTXT2(1)	na
=AFX_IDD_PRINTDLG_CANCEL(1)	Zrušit

=AFX_ID_PREVIEW_PRINT(1)	&Tisk...
=AFX_ID_PREVIEW_NEXT(1)	&Další stránka
=AFX_ID_PREVIEW_PREV(1)	Pře&dchozí stránka
=AFX_ID_PREVIEW_ZOOMIN(1)	Zvětšit &náhled
=AFX_ID_PREVIEW_ZOOMOUT(1)	Zmenšit &náhled
=AFX_ID_PREVIEW_CLOSE(1)	&Zavřít

=IDR_LBWLIST(1)	Datové seznamy\nNoName\nLBWDOC\nLOCKBASE-File (*.lbf)\n.LBF\nLBWDOC\nLOCKBASE-File
=IDR_LBWDSGN(1)	Systém Návrhář\nNoName\nLBWDOC\nLOCKBASE-File (*.lbf)\n.LBF\nLBWDOC\nLOCKBASE-File
=IDR_LBCWTYPE(1)	Systém Kalkulátor\nNoName\nLBWDOC\nLOCKBASE-File (*.lbf)\n.LBF\nLBWDOC\nLOCKBASE-File
=IDR_LBWMTRX(1)	Systém Matrix\nNoName\nLBWDOC\nLOCKBASE-File (*.lbf)\n.LBF\nLBWDOC\nLOCKBASE-File
=IDS_LBW_EXCHANGE(1)	LOCKBASE soubor (*.lbf)\nLOCKBASE template (*.lbt)\nLOCKBASE for DOS (*.sys)
=IDS_LBW_WEASELS(1)	Weasels rip my flesh!\n\nProgram LOCKBASE byl změněn. To může být způsobeno chybou pevného disku, počítačovým virem nebo manipulací se zdrojovým kódem programu.\n\nObnovte originální soubor ze zálohy nebo LOCKBASE instalační diskety.
=IDS_LBW_SHARE(1)	Nefukční sdílení!\nPro správnou funkčnost, LOCKBASE potřebuje DOS-Utility SHARE.EXE nebo  DOS-kompatibilní síť.
=IDS_LBW_DEMO_OUT(1)	Demoverzi LOCKBASE vypršela platnost!\nAktuální verzi získáte na'www.koertner-muth.com'\n nebo na adrese:\n\nKörtner & Muth GmbH\nEimsbütteler Chaussee 60-66, D-20259 Hamburg\n\nPhone: +49-40-4304436 Fax: +49-40-4304382\nEMail: lockbase@koertner.com
=IDS_LBW_DEMO(1)	Vítejte v programu LOCKBASE demo !\n\nTato demoverze je plně funkční ale změněná data nebo nově vytvořené systémy nebudou uloženy na disk.\n\nUžijte si LOCKBASE!
=IDS_LBW_DEMO_STORE(1)	Toto je LOCKBASE demoverze!\nNemůžete uložit žádná data na disk.
=IDS_LBW_LISTEND(1)	<nový>
=IDS_LBW_PRESENTATION(1)	Tento program může být použit za účelem prezentace a není licencován pro žádné komerční použití.\nTento program je ve vlastnictví firmy Körtner & Muth GmbH, Hamburg, Německo.
=IDS_PROTECT_FILELOCK(1)	Přístup k licenčnímu souboru (LBW.CFG) byl odepřen.\n\nLOCKBASE nemůže být licencována na dvou pracovních stanicích ve stejnou chvíli.Ukončete licenční proces na jedné pracovní stanici, prosím, než spustíte další.
=IDS_PROTECT_INVALID(1)	Licenční soubor (LBW.CFG) je neplatný nebo poškozen.\n\nKontaktujte technickou podporu servisního partnera LOCKBASE, prosím..
=IDS_LBW_PRESENTATION_OUT(1)	Životnost tohoto prezentačního programu vypršela.\nPro získání licence prosím kontaktujte:\n\nKörtner & Muth GmbH\nEimsbütteler Chaussee 60-66, D-20259 Hamburg\n\nPhone: +49-40-4304436 Fax: +49-40-4304382\nEMail: lockbase@koertner.com
=IDS_LBW_MODULE_LOADFAIL(1)	Soubor '%s' není uložen v adresáři LOCKBASE, mohl být poškozen nebo chybí některá jeho část.
=IDS_LBW_ERRSDB(1)	Chyba během otevírání systémové databáze LOCKBASE (LBW.SDB).
=IDS_LBW_LANGUAGE(1)	z
=IDS_APP_WIZBUTTONS(1)	&Dále >\nDokončit\n< &Zpět\nZrušit\n&Nápověda
=IDS_LISTVIEW(1)	Datové seznamy 
=IDS_MATRIXVIEW(1)	Systém Matrix 
=IDS_CALCULATORVIEW(1)	Systém Kalkulátor 
=IDS_DESIGNERVIEW(1)	Systém Návrhář 
=IDS_NEWTYPEDLG(1)	Šířka datových polí
=IDS_OE_NOT_FOUND(1)	Soubor nebyl nalezen.
=IDS_OE_IN_USE(1)	Soubor je uzamčen jiným uživatelem.
=IDS_OE_INVALID(1)	Soubor není dokument programu LOCKBASE nebo je poškozen.
=IDS_OE_NOLBF(1)	Soubor není dokument programu LOCKBASE.
=IDS_OE_VERSION(1)	Špatná verze LOCKBASE.
=IDP_DOC_MERGETREE(1)	Tento LOCKBASE soubor obsahuje skupinovou strukturu vytvořenou Systémem Návrhář.\nNačtením tohoto souboru bez Systému Návrhář dojde k smazání jeho skupinových struktur.\n\nMůže být skupinová struktura tohoto LOCKBASE systémového souboru smazána?
=IDP_DOC_NEWERVERSION(1)	Tento systémový soubor byl vytvořen novější verzí LOCKBASE a v této verzi nelze otevřít.\nPro získání aktualizace kontaktujte vašeho dodavatele LOCKBASE, prosím.
=IDS_OE_DISKSPACE(1)	na disku není žádné volné místo pro dočasné soubory.
=IDS_OE_READONLY(1)	Tento LOCKBASE soubor je chráněn proti zápisu. Možná je právě upravován na jiné pracovní stanici.\r\rSoubor byl otevřen pouze pro čtení. Provedené změny v souboru nebudou uloženy.
=IDS_OPTIONS_SYSTEMINFOFONT(1)	Změnit písmo a velikost písma systémových informací
=IDS_OPTIONS_LISTFONT(1)	Změnit písmo a velikost písma zobrazených datových skupin
=IDS_OPTIONS_FORMATLINES(1)	Změnit formát řádku vodorovně zobrazených datových skupin
=IDS_OPTIONS_FORMATCOLS(1)	Změnit formát řádku svisle zobrazených datových skupin
=IDS_EDIT_ADD(1)	Přidat datové skupiny do momentálně aktuálního seznamu\nPřidat datové skupiny do momentálně aktuálního seznamu
=IDS_EDIT_DELETE(1)	Vymazat vybrané datové skupiny\nVymazat vybrané datové skupiny
=IDS_EDIT_EDIT(1)	Upravit vybrané datové skupiny\nUpravit vybrané datové skupiny
=IDS_EDIT_ADDLINES(1)	Přidat datové skupiny do vybraného řádku seznamu\nPřidat datové skupiny do vybraného řádku seznamu
=IDS_EDIT_ADDCOLS(1)	Přidat datové skupiny do vybraného sloupce seznamu\nPřidat datové skupiny do vybraného sloupce seznamu
=IDS_EDIT_DELETELINES(1)	Vymazat datové skupiny z vybraného řádku seznamu\nVymazat datové skupiny z vybraného řádku seznamu
=IDS_EDIT_EDITCOLS(1)	Upravit datové skupiny ve vybraném sloupci seznamu\nUpravit datové skupiny ve vybraném sloupci seznamu
=IDS_EDIT_EDITLINES(1)	Upravit datové skupiny ve vybraném řádku seznamu\nUpravit datové skupiny ve vybraném řádku seznamu
=IDS_EDIT_DELETECOLS(1)	Vymazat datové skupiny z vybraného sloupce seznamu\nVymazat datové skupiny z vybraného sloupce seznamu
=IDS_FILE_PRINTSELECTION(1)	Spustit správce tisku k vytištění dokumentů LOCKBASE \nSpustit správce tisku k vytištění dokumentů LOCKBASE 
=IDS_EDIT_CONNECT(1)	Přidat nebo odstranit spojení mezi datovými skupinami \nPřidat nebo odstranit spojení mezi datovými skupinami
=IDS_FILE_SYSTEMINFO(1)	Zobrazit a upravit Systém Hlavička\nZobrazit a upravit Systém Hlavička
=IDS_WINDOW_ACTIVATENEXT(1)	Přejdi do následujícího datového skladu pro úpravu dat
=IDS_WINDOW_ACTIVATEPREV(1)	Přejdi do předchozího datového skladu pro úpravu dat
=IDS_WINDOW_ARRANGELISTS(1)	Zobraz aktivní list v plné velikosti\nZobraz aktivní list v plné velikosti
=IDS_OPTIONS_VIEWS(1)	Určit, které okno se zobrazí při spuštění LOCKBASE
=IDS_WINDOW_STARTMATRIX(1)	Otevřít okno Systém Matrix\nOtevřít okno Systém Matrix
=IDS_WINDOW_STARTCALCULATOR(1)	Otevřít okno Systému Kalkulátor pro kalkulaci\nOtevřít okno Systému Kalkulátor pro kalkulaci
=IDS_WINDOW_STARTDESIGNER(1)	Otevřít okno Systému Návrhář\nOtevřít okno Systému Návrhář
=IDS_WINDOW_STARTLIST(1)	Otevřít okno Datových seznamů\nOtevřít okno Datových seznamů
=IDS_OPTIONS_STRINGFORM(1)	Nastavit formát řádku, pořadí datových polí a třídění
=IDS_EDIT_GROUPSELECT(1)	Otevřít seznam skupin pro změnu aktivní skupiny
=IDS_CALC_EDITRANGE(1)	Upravit rozsah frézovaní klíče vybrané skupiny\nUpravit rozsah frézovaní klíče vybrané skupiny
=IDS_CALC_EDITCODE(1)	Upravit kombinaci vybraného klíče\nUpravit kombinaci vybraného klíče
=IDS_CALC_CALC(1)	Spustit nebo zastavit kalkulaci\nSpustit nebo zastavit kalkulaci
=IDS_CALC_TRANSFER(1)	Přenos dat mezi kalkulátorem a datovými sklady vložek  klíčů\nPřenos dat mezi kalkulátorem a datovými sklady vložek  klíčů
=IDS_FILE_READER(1)	Vytvořit disk Manager lite pro aktivní soubor
=IDS_OPTIONS_LASTFILE(1)	Určit, zda má po spuštění LOCKBASE být načten posledně použitý systém
=IDS_OPTIONS_TOOLBAR(1)	Skrýt nebo zobrazit nástrojovou lištu
=IDS_OPTIONS_STATUS_BAR(1)	Skrýt nebo zobrazit stavový řádek
=IDS_VIEW_SHOWCONNECTED(1)	Skrýt nebo zobrazit spojení mezi datovými sklady\nSkrýt nebo zobrazit spojení mezi datovými sklady
=IDS_FILE_MACHINE(1)	Export informací frézování/rozpis stavítek do počítače řídícího stroj
=IDS_VIEW_CONNECTEDONLY(1)	Zobrazit pouze spojené položky aktuální datové skupiny
=IDS_CALC_CGA(1)	Otevřít dialogové okno Správa kódových skupin\nOtevřít dialogové okno Správa kódových skupin
=IDS_OPTIONS_USECGA(1)	Umožnit nebo neumožnit Správu kódových skupin
=IDS_OPTIONS_EUROFORMAT(1)	Zobrazení Systému Matrix v komprimovaném tvaru (vložky, seřazené klíče, centrální vložky)
=IDS_OPTIONS_FUNCONLY(1)	Skrýt vložky uzamykané stejně a zobrazit pouze vložky uzamykané rozdílně\nSkrýt vložky uzamykané stejně a zobrazit pouze vložky uzamykané rozdílně\nSkrýt vložky uzamykané stejně a zobrazit pouze vložky uzamykané rozdílně\nSkrýt vložky uzamykané stejně a zobrazit pouze vložky uzamykané rozdílně
=IDS_OPTIONS_KEYRETURN(1)	Určit zda po spuštění Datových seznamů mají být zobrazeny Opožděně vrácené klíče
=IDS_EDIT_KEYRETURN(1)	Zprávy o klíčích s dosaženým či překročeným datem vrácení
=IDS_FILE_B2B_INBOX(1)	Otevřít dialogové okno a vypsat příchozí poštu\nVyvolat a dialogové okno otevření a vyvolat příchozí poštu
=IDS_FILE_B2B_SENDTHIS(1)	Otevřít dialogové okno pro odeslání tohoto uzamykacího plánu\nOtevřít dialogové okno pro odeslání tohoto uzamykacího plánu
=IDS_FILE_B2B_EXCHANGE(1)	Odeslat zpracované soubory a doručit příchozí soubory přes internet\nOdeslat zpracované soubory a doručit příchozí soubory přes internet
=IDS_OPTIONS_B2B_AUTOEXCHANGE(1)	Umožnit automatickou datovou přes internet po spuštění programu
=IDS_EDIT_CONSISTENCY(1)	Ověření duplikátů vložek nebo jmen klíčových funkcí a dalších\nOvěření duplikátů vložek nebo jmen klíčových funkcí a dalších
=IDS_VIEW_GROUNDPLAN(1)	Přepínání mezi půdorysy a zobrazeným seznamem datové skupiny dveří
=AFX_IDS_IDLEMESSAGE(1)	F1 pro Nápovědu
=AFX_IDS_HELPMODEMESSAGE(1)	Vyberte cíl k získání nápovědy
=IDS_FILE_NEW(1)	Vytvořit nový soubor systému LOCKBASE\nVytvořit nový soubor systému LOCKBASE
=IDS_FILE_OPEN(1)	Otevřít existující soubor systému LOCKBASE\nOtevřít existující soubor systému LOCKBASE
=IDS_FILE_CLOSE(1)	Zavřít všechna okna souboru systému LOCKBASE\nZavřít všechna okna souboru systému LOCKBASE
=IDS_FILE_SAVE(1)	Uložit všechny aktivní soubory systému LOCKBASE\nUložit všechny aktivní soubory systému LOCKBASE
=IDS_FILE_SAVE_AS(1)	Uložit aktivní soubor systému LOCKBASE pod novým názvem\nUložit aktivní soubor systému LOCKBASE pod novým názvem
=IDS_FILE_PRINT(1)	Otevřít dialogové okno Tisku
=IDS_FILE_PRINT_PREVIEW(1)	Náhled vybraných datových seznamů, protokolů nebo dopisů
=IDS_FILE_MRU_FILE1(1)	Otevřít vybraný soubor systému LOCKBASE
=IDS_FILE_MRU_FILE2(1)	Otevřít vybraný soubor systému LOCKBASE
=IDS_FILE_MRU_FILE3(1)	Otevřít vybraný soubor systému LOCKBASE
=IDS_FILE_MRU_FILE4(1)	Otevřít vybraný soubor systému LOCKBASE
=IDS_WINDOW_NEW(1)	Otevřít nové okno pro aktivní systém
=IDS_WINDOW_ARRANGE(1)	Uspořádat ikony ve spodní části okna
=IDS_WINDOW_CASCADE(1)	Uspořádat okna překrytě
=IDS_WINDOW_TILE_HORZ(1)	Uspořádat okna vedle sebe
=IDS_WINDOW_TILE_VERT(1)	Uspořádat okna pod sebe
=IDS_WINDOW_SPLIT(1)	Uspořádat okna jako dlaždice
=IDS_APP_ABOUT(1)	Zobraz autorská práva,informace o verzi a výrobní číslo
=IDS_APP_EXIT(1)	Ukončit LOCKBASE
=IDS_HELP_INDEX(1)	Zobraz obsah nápovědy\nZobraz obsah nápovědy
=IDS_HELP_USING(1)	Zobraz informace, jak použít nápovědu
=IDS_CONTEXT_HELP(1)	Zobraz nápovědu kliknutím na tlačítka, menu a okna\nZobraz nápovědu kliknutím na tlačítka, menu a okna
=IDS_HELP(1)	Zobraz nápovědu pro aktuální úlohu nebo příkaz\nZobraz nápovědu pro aktuální úlohu nebo příkaz
=IDS_INDICATOR_EXT(1)	EXT
=IDS_INDICATOR_CAPS(1)	CAP
=IDS_INDICATOR_NUM(1)	NUM
=IDS_INDICATOR_SCRL(1)	SCRL
=IDS_INDICATOR_OVR(1)	OVR
=IDS_INDICATOR_REC(1)	REC
=AFX_IDS_SCSIZE(1)	Změnit velikost okna
=AFX_IDS_SCMOVE(1)	Změnit pozici okna
=AFX_IDS_SCMINIMIZE(1)	Minimalizovat okno
=AFX_IDS_SCMAXIMIZE(1)	Maximalizovat okno
=AFX_IDS_SCNEXTWINDOW(1)	Přejít na následující okno dokumentu
=AFX_IDS_SCPREVWINDOW(1)	Přejít na předchozí okno dokumentu
=AFX_IDS_SCCLOSE(1)	Zavřít aktivní okno a nabídnout uložení dokumentu
=AFX_IDS_SCRESTORE(1)	Obnovit okno do normální velikosti
=AFX_IDS_SCTASKLIST(1)	Aktivovat seznam úloh
=AFX_IDS_MDICHILD(1)	Aktivovat toto okno
=IDP_ERRORSTORESYS(1)	Systém nelze uložit!
=IDP_ERRORADDITEM(1)	Položku nelze uložit!
=IDP_CURRDIRNOTEVALUATED(1)	Tento adresář nelze nalézt!
=IDP_CANTDELETECONNECTEDITEM(1)	Nelze smazat spojené položky!
=IDP_POSNOTFOUND(1)	Pozice nebyla nalezena!
=IDP_NOITEMSELECTED(1)	Položka nebyla vybrána !\n Vyberte položku,prosím.
=IDP_IDNOTFOUND(1)	ID položky nebylo nalezeno!
=IDP_NOMOUSE(1)	Myš není nainstalovaná.\nPoužíváním myši je ovládání LOCKBASE snazší.
=IDP_INSERTNUMCHAR_CYL(1)	Nezadali jste znak pořadí (@) do datového pole 'číslo'.\rChcete vytvořit vložky uzamykané stejně?
=IDP_SELECTAFRAME(1)	Nebylo vybrán úvodní zobrazení.\nPoužijte menu Možnosti, prosím/Vyberte jedno nebo víc zobrazení dat, které budou spuštěna při otevření souboru.
=IDP_FIELDEMPTY(1)	Toto pole nesmí být prázdné.
=IDS_PRTF_DATALISTS(1)	Zobraz seznamy
=IDS_PRTF_MATRIXVW(1)	Systém Matrix
=IDS_PRTF_CALCULATOR(1)	Systém Kalkulátor
=IDS_PRTF_DESIGNER(1)	Systém Návrhář
=IDS_PRTF_COVERSHEET(1)	Systém Hlavička\n\n\nHistorie:
=IDS_PRTF_MATRIXPRN(1)	Systém Matrix
=IDS_PRTF_PINNINGLIST(1)	Rozpis stavítek
=IDS_PRTF_CYLREPAIR(1)	Objednávka\nObjednávka opravy vložky\n\nTímto objednáváme 1 kus od každé z následujícího seznamu vložek(s):||Datum:|Systém:|Značka:|(Místo, Datum)|(Podpis)|Do|Částka
=IDS_PRTF_CYL2KEY(1)	Řádkový seznam\nSeznam vložek - klíčů
=IDS_PRTF_CYLINDER(1)	Seznam\nSeznam vložek
=IDS_PRTF_BITTINGLIST(1)	Seznam frézování klíčů
=IDS_PRTF_KEYISSUE(1)	Potvrzení výdeje klíče\n\n\npan/paní @ potvrzuje přijetí následujícího(ch) klíče(ů):||Datum:|Systém:|Značka:|(Místo, Datum)|(Podpis)|Do
=IDS_PRTF_KEYRETURN(1)	Potvrzení příjmu klíče\n\n\nPotvrzujeme panu/paní @ příjem následjicího(ch) klíče(ů):||Datum:|Systém:|Značka:|(Místo, Datum)|(Podpis)|Do
=IDS_PRTF_KEYSTOCK(1)	Seznam klíčů na skladě\n\n\nPodpis
=IDS_PRTF_CONNECTDLG(1)	Spojit Dialogové okno
=IDS_PRTF_KEYEDITDLG(1)	Seznam klíčů
=IDS_PRTF_STICKERCYLINDERS(1)	Etikety vložek
=IDS_PRN_FORMATDLG(1)	<None>\ntučné|italic|Podtržené|Kurzíva\nNázev|Podtitul|Záhlaví|Zápatí|Popis|Data|Systém|Text
=IDS_PRN_HEADERSTR(1)	LOCKBASE\nSystém: \nState: \nZnačka: \nReg. číslo: \nVytvořil: \n
=IDP_PRN_FORMATDLG_ERR_DATASTOCK(1)	Nemůžete daný datový sklad vybrat více než jednou.
=IDS_PRN_SELECTDLG(1)	[Různé nastavení tisku]
=IDS_PRN_PRINTLIB(1)	Na výšku|Na šířku
=IDS_PRN_PINNING(1)	Kódování
=IDS_PRN_PAGEINFO(1)	Strana %i z %n\nStrana %i z %n (Výňatek)\nStrana %c%r z %nc%nr\nStrana %i (Výňatek)
=IDS_MTRX_INFOSTR(1)	Systém:\nVlastník:\nZákaznické číslo:\nUlice:\nMěsto:\nZemě:\nDodavatel:\nTyp systému:\nZnačka:\nVýroba:\nNaposledy změněno:\nPoznámky:\n
=IDP_DOC_ERRORCANTDELETE(1)	Ne všechny datové skupiny mohou být vymazány!
=IDP_DOC_RECALC(1)	Tento vstup vyžaduje kompletní rekalkulaci!\nOvěřte existující kalkulaci v Systému Kalkulátor, prosím!
=IDS_DOC_UPDATE(2)	Probíhá aktualizace verze... (%d)
=IDS_DOC_ADDDATASET(1)	Vytváření Datových skupin: %d%%\n
=IDS_DOC_ANALYSE(1)	Analýza skupiny %s...\nPřekrytí mezi skupinami %s a %s: Sloučení skupin\n
=IDS_DOC_REMDATASET(1)	Vymazání datových skupin: %d%%\n
=IDP_DOC_FILENOTFOUND(1)	Soubor %s nebyl nalezen!
=IDS_DOC_IMPORT(1)	Probíhá úprava dat: %s (%d%%) ...\nPřevzít existující kalkulace: %s (%d%%) ...\n
=IDP_DOC_IMPORTWRONGTYPE(1)	Chyba během otvírání souboru\nVybraný soubor neobsahuje očekávaná data.\nTento soubor se zdá být starší verzí souboru formátu 'Superlock'. LOCKBASE čte soubory vytvořené ve verzi 'Elcon Superlock Universal 6.11'.
=IDP_DOC_IMPORTERROR(2)	Došlo k chybě během úpravy dat!\nNelze otevřít soubor %s.\nNelze číst ze souboru %s.\nChybná data nalezena v souboru %s.\nNelze přidat datovou skupinu.\n%s
=IDP_DOC_ASKMOVE(1)	Potvrďte přesunutí, prosím %lu %s
=IDS_DOC_MGLUPDATE1(1)	Klíč '%s', vydán '%s' nebyl nalezen\nVložka '%s', postavená do '%s' nebyla nalezena\nPříprava aktualizace ...\nProbíhá aktualizace (%u%%)\nNelze provést aktualizaci: Starý soubor nelze otevřít.\n
=IDS_DOC_MGLUPDATE2(1)	Došlo k chybě během aktualizace . Vyberte 'Potvrdit' k přijmutí aktualizace kdykoliv nebo vyberte 'Zrušit' k obnovení předchozího stavu systému.
=IDS_DOC_MGLUPDATE3(1)	Aktualizace proběhla úspěšně. Předchozí stav systému bude uložen do souboru '%s.lb1'.\nPředchozí stav systému byl obnoven. Aktualizace bude vymazána.
=IDS_DOC_MGLUPDATE4(1)	Klíč '%s', vydán '%s' nebyl nalezen\nVložka '%s', postavená do '%s' nebyla nalezena\nPříprava aktualizace ...\nProbíhá aktualizace (%u%%)\nVýrobní číslo starého souboru je vadné. Nelze provést aktualizaci.
=IDS_DOC_EVVASAT_TXT(1)	EVVA-Systém:\nano\nne\nDoadací adresa:\nFakturační adresa:\nVýrobce: \nPříslušný klíč \n
=IDS_DOC_EVVASAT_ERR(1)	Chyba v souboru '%s', řádek %ld , pole %ld:\nNelze otevřít soubor.\nNeočekávaný formát souboru.\nNeznámý nebo neočekávaný typ datového pole.\nNedostatek paměti.\nNalezen neočekávaný konec souboru.\nInterní chyba.
=IDP_CALC_RECALC(1)	Tento vstup vyžaduje kompletní rekalkulace!
=IDP_CALC_NOGROUP(1)	Vadná Kódová skupina!
=IDP_CALC_NOPROFILE(1)	Vadný Profil!
=IDP_CALC_NOHS(1)	Vadný Generální klíč:\n%s
=IDP_CALC_GROUPERROR(1)	Konflikt skupin!\nKombinacemi ze skupiny %s je možné otevřít vložku za skupiny %s. %s
=IDP_CALC_KILLALL(1)	Tento vstup vyžaduje kompletní rekalkulace %s! 
=IDP_CALC_STOP_ACTIVE(1)	Kalkulace zrušena!
=IDP_CALC_NOCODE(1)	Vadná kombinace:\n%s
=IDP_CALC_ERROR(1)	Detekováno špatné nastavení:\nklíč %s nelze zabudovat do vložky %s (z důvodů jiných klíčů).%s\nKlíč %s otevře vložku %s.%s\nVadné kódování nalezeno ve vložce %s. Frézování náležejících klíčů není kompatibilní.
=IDP_CALC_STOP_FAIL(1)	Selhání kalkulace! \nRzsah frézování klíče je příliš malý!
=IDP_CALC_STOP_SUCCESS(1)	Kalkulace dokončena!\nVšechny kombinace v '%s' jsou zkalkulovány.
=IDP_CALC_NO_VACANT(1)	Všechny kombinace jsou již zkalkulovány.
=IDS_CALC_SUPERHS(1)	\nKombinace nadřazeného klíče je příčinou této chyby.
=IDP_CALC_NOFABSET(1)	Soubor LBW.FAB není uložen v adresáři LOCKBASE nebo byl poškozen!\nZnačka není dostupná!
=IDP_CALC_OVERWRITE(1)	Systém byl již zkalkulován!\nChcete přepsat staré kombinace?
=IDP_CALC_AFTERENTER(1)	Frézování klíčů a kódy vložek byly přeneseny do databáze!
=IDS_CALC_DBLEMPTY(1)	Obě pozice v dvojitém řezu %u jsou prázdné.
=IDS_CALC_MACSERROR(1)	Rozdíl mezi sousedícími řezy na pozici %u je příliš velký (MACS-narušení).
=IDS_CALC_4EQUAL(1)	Příliš mnoho stejných frézování.
=IDS_CALC_3NEIGHBOURS(1)	Příliš mnoho stejných sousedících frézování.
=IDS_CALC_STAIRS(1)	Lineárně vzestupná nebo sestupná část (kaskáda).
=IDS_CALC_MINDIFF(1)	Rozdíl mezi nejmělčím a nejhlubším frézováním je příliš malý. 
=IDS_CALC_HSLENGTH(1)	Příliš mnoho nebo příliš málo definovaných řezů.
=IDP_CALC_EDITCODE(1)	Kombinace není v rozsahu frézování klíče skupiny .
=IDS_CALC_INVPIN(1)	Vadný kód stavítka na pozici %u.
=IDS_CALC_TRANSFER_IN(1)	Přenos...\nUpozornění: Kód %s je v rozporu s nastavením standardů. %s\nChyba: Kód %s je vadný. %s\nOvěřit %s...\nJe detekováno překrytí skupin %s a standardů %s: Sloučení skupin...\nPřenos dokončen.\n
=IDS_CALC_TEST(2)	Analýza skupiny %s...\nPřekrytí mezi skupinou %s a %s: sloučení skupin\nInicializace interních dat %u%%\nOveření aktuální kalkulace %u%%\nkalkulace...
=IDS_CALC_USEANYWAY(1)	\nMůže být kombinace použita kdykoliv?
=IDP_CALC_ERROR1(1)	\nKlíč bude překalkulován.
=IDP_CALC_RANGE_SMALLER(1)	Z důvodu omezení rozsahu frézování nejméně některé kombinace musí být překalkulovány.\rMají být ostatní kombinace v '%s' ponechány?
=IDP_CALC_RANGE_LARGER(1)	Rozsah kalkulace '%s' byl rozšířen dle těchto nastavení.\rMají být poslední zkalkulované kombinace ponechány?
=IDP_CALC_NEWMASTER(1)	Kombinace generálního klíče byla změněna.\rMají být poslední zkalkulované kombinace v '%s' přepočítány (doporučeno)?
=IDS_CALC_TRANSFER_OUT(1)	Přenos...\nVložka %s: Stavební ball nahrazení chyby error\nPřenos dokončen.
=IDS_CALC_TRANSFER_CHG(1)	Vyhledávání změn ...\nKlíč %s: \nVložka %s: \nFrézování\nRozpis stavítek\nProfil\nVyhledávání dokončeno.
=IDS_CALC_EDITCODE_FLAG(1)	&Jedna strana zcela mechanická
=IDS_CALC_CODELIST_DISABLED(1)	[Deaktivováno]
=IDS_DESGN_DOORPATTERN(1)	Šablona Dveře
=IDS_DESGN_CROSSPATTERN(1)	Šablona Skupinový klíč
=IDS_DESGN_KEYPATTERN(1)	Šablona příslušný klíč
=IDS_DESGN_CYLPATTERN(1)	Šablona Vložka
=IDS_DESGN_Z(1)	Centrální vložka
=IDS_DESGN_HS(1)	Generální klíč
=IDS_DESGN_KILLHS(1)	Potvrďte smazání skupinového klíče skupiny %s, prosím.
=IDS_DESGN_KILLZ(1)	Potvrďte smazání centrální vložky skupiny %s, prosím.
=IDS_DESGN_KILLGRP(1)	Potvrďte smazání %s, prosím.
=IDS_DESGN_HSEDIT(1)	Upravit M&K...
=IDS_DESGN_HSADD(1)	Přidat M&K...
=IDS_DESGN_ZEDIT(1)	Upravit M&C...
=IDS_DESGN_ZADD(1)	Přidat M&C...
=IDP_DESGN_EMPTYDLG(1)	Nebyla vložena data pro %s\ngenerální klíč\n centrální vložku\nskupinový klíč\nvložku\npříslušný klíč\ndveře\n
=IDS_STRFRM_OWNER(1)	\n<S!>Příjmení\n<S!>Křestní jméno\nUlice\n<S!>Město\nZemě\nTelefon (Kancelář)\nTelefon (Soukromý)\n<S!>Osobní číslo\n<S!>Oddělení\nFunkce/Titul\n
=IDS_STRFRM_FUNCTION(1)	\n<S!>Označení klíče\n<S!>Popis\n<S!>Počet klíčů\nProfil\nKódová skupina\nKombinace\nTyp\nType description\nPočet klíčů (aktuální)
=IDS_STRFRM_KEY(1)	\n<S!>Držitel klíče\n<S!>Oražení\n<T>Vyrobeno\n<T!>Výdej\n<T!>Příjem\n<C!>Stav*Objednán*Dostupný*Vydán*Chybí*Zničen\nPoznámky
=IDS_STRFRM_CYLINDER(1)	\n<S!>Číslo\n<S!>Typ\n<S!>Délka\n<S!>Povrch\n<S!>Popis dveří\n<T!>Naposledy změněno\nPříslušný klíč\nKódová skupina\nProfil\n\nPočet klíčů\nKódování\nOznačení klíče\n<S!>Množství\n<S!>Zvláštní úprava\nPoz.\n\n<S!>Building\nType description\nItem code\n<S!>Order\n\nPočet klíčů (aktuální)
=IDS_STRFRM_DOOR(1)	\n<S!>Dveře\n<S!>Budova/Odd.\nPopis\n<S!>Délka vložky\nZámek 1\nZámek 1 Typ\nZámek 1 rozměr\nZámek 2\nZámek 2 Typ\nZámek 2 rozměr\n
=IDS_STRFRM_FUNCTION_1(1)	\n<S!>Označení\n<S!>Popis\n<S!>Počet klíčů\n\n\n\nTyp\nType description\nPočet klíčů (aktuální)
=IDS_STRFRM_CYLINDER_1(1)	\n<S!>Číslo\n<S!>Typ\n<S!>Délka\n<S!>Povrch\n<S!>Označení dveří\n<T!>Naposledy změněno\nPříslušný klíč\n\n\n\nPočet klíčů\n\n\nPopis klíče\n<S!>Množství\n<S!>Speciální úpravy\nPozice\n\n<S!>Building\nType description\nItem code\n<S!>Order\n\nPočet klíčů (aktuální)
=IDS_STRFRM_SYSINFO(2)	Systém\nVlastník\nZákaznické číslo\nTyp systému\n\n\nDodavatel\nZnačka\n<T>Výroba\n<T>Upraveno\nPoznámka\n\n\n\n\nBezpečnostní karta
=IDS_STRFRM_EVENT_SYSEXP(1)	\n\n<T>Datum\n\nPopis\nVytvořil\nRegistrační číslo\n<T>Datum objednání\n<T>Datum dodávky\nZpůsob doručení\nPoznámky\n
=IDS_STRFRM_EVENT_KEY(1)	\n\n<T>Datum\n\nPopis\nSprávce\nPodpis\nDržitel klíče\nKlíč\nPoznámka\n
=IDS_STRFRM_EVENT_CYL(1)	\n\n<T>Datum\n\nPopis\nSprávce\nPodpis\nVložka\nDveře\nPoznámka\n
=IDP_SETPWD_OLDPWD(1)	Neplatné staré heslo!
=IDP_SETPWD_RETYPE(1)	Heslo a jeho ověření nesouhlasí!
=IDP_CHECKPWD_FAIL(1)	Neplatné heslo!
=IDS_SETPWD_BUTTON_SET(1)	Vložit &Heslo...
=IDS_SETPWD_BUTTON_CHG(1)	Změnit &Heslo...
=IDP_PROCVIEW_CANCEL(1)	Zastavit proces?
=IDS_READER_STR(1)	Soubor nebyl nalezen!\nNení přístup!\nNeznámá chyba!\nPřed vytvořením disku Manager Lite uložte systém, prosím\nInstalace složky proběhla úspěšně a byla umístěna na plochu.!\nNelze vymazat starý Manager lite!\nDisk nebyl vytvořen!\nCílová cesta nemůže být v adresáři LOCKBASE
=IDS_READER_COPY(1)	Kopíruji %s...
=IDP_READER_INVPATH(1)	Nelze vytvořit cestu!\rVložte prosím: [Disk]:\\[...]\\[Adresář]\rAdresáře musí existovat před vytvářením Managera lite .
=IDS_READER_CANTCOPYFILE(1)	Nelze kopírovat soubor %s.
=IDP_READER_CANTSEALEXE(1)	Nelze vytvořit rozbalovací soubor Manager lite.
=IDP_READER_CANTCOPYREADERFILES(1)	Soubory nelze kopírovat do cílového adresáře.
=IDS_READER_CREATINGEXE(1)	Vytvářím Manager lite...
=IDP_READER_INVDOC(1)	Soubor LBW.LBF je poškozen a nelze ho otevřít.
=IDP_READER_CONFIRM(1)	Číslo systému, jméno zákazníka a adresu po vytvoření Managera Lite nelze změnit.\r\rJste si jisti, že vložená data jsou správná?
=IDP_READER_USERDATA(1)	Číslo systému, jméno zákazníka a adresa je nekompletní.\r\rMusíte zadat číslo systému, jméno zákazníka a adresu k disku Manager lite.
=IDP_READER_UNLOCK(1)	Licenční kód je neplatný.\r\rK vytvoření disku Manager lite disk musíte vložit platnou licenci, kterou můžete získat od svého dodavatele LOCKBASE.
=IDS_READER_DISKSPACE(1)	Není žádné volné místo na cílovém disku.\rVložte další disk, prosím.
=IDP_READER_DEMO(1)	Nevložili jste licenční kód.\r\rLOCKBASE vytvoří demoverzi programu Manager lite pro tento systém generálního klíče.
=IDP_READER_PASSWORD(1)	Tento systém je chráněn heslem. Chcete toto heslo použít také k ochraně disku Manager-lite?
=IDS_PRTF_ASSEMBLY(1)	Seznam materiálu\n\n\nTělesová stavítka|Mezistavítka|Bubínkovástavítka|Klíč|Typ|Profil|Množství|Typ vložky|Spec. úpr.|Povrch|Rozměr|Délka bubínku / Typ|Generální klíče|Skupinové klíče|Skupinové Klíče|Skupinové klíče|Příslušné klíče|Cena|Celcem|Celková hodnota|Celková cena
=IDS_PRTF_KEY_HISTORY(1)	Historie Klíčů
=IDS_PRTF_CTRLKEYLIST(1)	Kontrolní seznam klíčů\n\n\nKontrolovat klíč|vložky
=IDS_PRTF_COMBIPINNINGLIST(1)	Kombinovaný seznam sestavení
=IDS_PRN_ASSEMBLY_DETECT(1)	Problém analýzy rozměru %s ve vložce typu %s.\nJe to oboustranná vložka?\n
=IDP_PRN_PRINTFROMFILE(1)	Chyba při načítání tiskopisu <%s>:\nNeznámý příkaz v řádku %u.\nChyba syntaxe v řádku %u, Poz. %u.\nNelze otevřít tiskopis.
=IDS_MACHINE_OUT(1)	Exportuji data %u%%\n
=IDP_MACHINE_OVERWRITE(1)	Vybraný výstupní soubor již existuje.\nPřepsat?
=IDS_MACHINE_ERRORS(1)	Nelze otevřít výstupní soubor.\nNelze zapisovat do výstupního souboru.\nNelze zavřít výstupní soubor.\nVadná data detekována během zápisu položky '%s'.\n
=IDP_MACHINE_CIAO(1)	Přenos dat úspěšně dokončen.
=IDS_MACHINE_SELECTBOX(1)	Exportovat data do
=IDS_MACHINE_NOCARDNO(1)	Není vloženo číslo karty pro Silca Unocode!\nStiskněte 'Nastavení' pro vložení platného čísla karty.
=IDS_MACHINE_NOFAB(1)	Nebyla vložena značka!\nSpecifické hodnoty značky nelze nastavit.
=IDS_MACHINE_ECOSFILE(1)	Börkey Ecos II výchozí soubor značky
=IDS_MACHINE_NOECOSFILE(1)	Název výstupního souboru (%s) se liší od aktuálně používané definice (%s)\n\nNahradit použité pod novým jménem souboru?
=IDS_MACHINE_NOTINSETUP(2)	Strojní rozhraní není ještě nastaveno pro tuto značku!\n%s\nStiskněte 'Nastavení' pro vložení požadovaných definicí.
=IDS_MACHINE_UNOCODESTR(1)	Silca Unocode nastavení\n&Značka/Číslo karty:\n&Číslo karty:\n
=IDS_MACHINE_ECOSSTR(1)	Börkey Ecos II nastavení\n&Značka/Požití:\n&Použití:\n
=IDP_MACHINE_ECOSWARN(1)	Upozornění!\nJméno klíče obsahuje nečíselný znak - Ecos II Series nedostupná funkce pro řezání přenesených klíčů.
=IDP_MACHINE_NOTRANSFER(1)	Strojní rozhraní není dostupné dokud informace o frézování a rozpisu stavítek nebudou přeneseny z Kalkulátoru do datových skupin.\n\nNicméně, dosud žádný přenos neproběhl.
=IDP_MACHINE_BRANDERROR(1)	Systém generálního klíče značky '%s' nemůže být přenesen do vybraného stroje.
=IDS_MACHINE_QUATTROSTR(1)	Silca Quattrocode nastavení\n&značka/Silca výrobní číslo:\n&Silca výrobní číslo:\n
=IDP_CGA_NOCGA(1)	LOCKBASE nemůže spustit správu kódových skupin.\n\nSoubor LBWCGA.EXE není uložen v adresáři LOCKBASE, byl poškozen nebo jej nelze načíst z jiného důvodu (např. Windows 3.1 nebo nižší).
=IDP_LISTS_CREATE_DOORS(1)	Potvrďte vytvoření datové skupiny dveří z dat popisu dveří vložek.\n%lu Dveře byly vytvořeny.\nŽádné dveře nebyly vytvořeny ů všechny dveře již existují.
=IDP_LISTS_NOKEYRETURN(1)	Všechny klíče s omezenou platností jsou vráceny.
=IDS_LISTS_PROCVIEW_KEYRETURN(1)	vyhledávání klíčů s omezenou platností: %d%%
=IDP_LISTS_GROUNDPLAN_ERR(1)	Došlo k následující chybě:\nNázev chybí nebo byl již použit v jiném půdorysu.\nDaný soubor nebyl nalezen.\nDaný soubor není v grafickém formátu nebo není podporován.\n
=IDP_LISTS_GROUNDPLAN_DEL(1)	Jste si jisti, že chcete smazat tento půdorys?
=IDP_LISTS_GROUNDPLAN_REMITEMS(1)	Jste si jisti, že chcete odstranit %lu dveře z tohoto půdorysu?
=IDP_LISTS_GROUNDPLAN_LOAD(2)	Chyba během načítání půdorysu '%s':\nNeplatný název půdorysu.\nNebyl zadán zdrojový soubor půdorysu. Vložte znova umístění souborů, prosím.\nGrafický soubor s půdorysem není na očekávaném místě.Prosím vložte znovu umístění souboru.\nPůdorys není grafický soubor nebo je v nepodporovaném formátu. vyberte jiný soubor, prosím.
=IDP_BRANDSET_IMPORTERROR(1)	Problémy během inicializace modulu značky %s:\nNelze otevřít soubor '%s' .\nSoubor '%s' obsahuje vadná data.\nNelze zapsat do souboru '%s'.
=IDP_BRANDSET_IMPORTOK(1)	Data modulu značky %s byla úspěšně aktualizována.
=IDP_DOC_ASK_TO_SAVE(1)	%s byl upraven.\nChcete uložit změny?
=IDP_DOC_CGA_TO_SAVE(1)	Uvědomte si, že změny provedené ve Správě kódových skupin musí být opraveny manuálně, pokud soubor není uložen.
=IDS_DOC_EVVASAT_UNRESOLVED(1)	Chyba v souboru '%s', řádku %ld , poli %ld:\nSystém Matrix nebyl vyřešen. Pro více informací týkajících se vyřešení Matrixu odkazujeme na uživatelský manuál Evva-Satellit.
=IDP_DOC_IMPORTERROR1(1)	Došlo k chybě během převodu dat!\nSoubor %s, Záznam %ld, Pole %ld obsahuje vadná nebo neočekávaná data.\nSoubor %s, Záznam %ld obsahuje vadná nebo neočekávaná data.
=IDP_DOC_IMPORTERROR_GENERAL(1)	Došlo k chybě během importu dat!\nNelze vytvořit adresář %s.\nSoubor %s nebyl nalezen. Tento program musí být umístěn v adresáři LOCKBASE.\nZip soubor neobsahuje očekáváné soubory.
=IDP_DOC_KWDERROR(1)	Došlo k chybě během importu dat!\nSoubor %s není KWD-soubor.\nTento typ souboru KWD není podporován.\rLOCKBASE podporuje pouze KWD typ 'Schließanlage mechanisch komplett mit Schließungen'.
=IDS_DOC_KWD(1)	Probíhá převod dat: Soubor %s, Řádek %ld ...\nVytvářím kopie klíčů %d%% ...\nVytvářím příslušných klíčů %d%% ...\nVytvářím spojení %d%%...\n
=IDS_DOC_EXPORT(1)	Probíhá převod dat: %s (%d%%) ...
=IDS_DOC_IMPORT_GENERAL(1)	Rozbaluji soubory ...\nKontroluji soubory ...\nProbíhá převod dat: %s (%d%%) ...
=IDP_DOC_REMCHGKEYS_FAIL(1)	Nelze smazat všechny příslušné klíče. Některé z nich již byly vydány uživatelům.
=IDP_DOC_NOSUPERUNCHECK(1)	Atribut 'Centralní vložka' nelze odstranit u %lu z %lu vložek, jelikož stále existuje spojení s příslušnými klíči dalších vložek.
=IDP_DOC_ASKMYKEY_DISCONNECT(1)	Nelze vymazat spojení mezi vložkou a jejími příslušnými klíči.\r\rJste si jisti, že chcete oddělit vložku '%s' od jejích příslušných klíčů?
=IDP_DOC_MAKECYLFUNC(1)	Chcete nastavit vybrané vložky jako uzamykané stejně '%s'?
=IDP_DOC_CLRCYLFUNC(1)	Vybrané vložky jsou uzamykané stejně.\rChcete je nastavit jako uzamykané rozdílně?
=IDP_DOC_MAKECYLFUNCFAIL(1)	Všechny vložky nemohou být uzamykané stejně.\rUvědomte si, že vložky, které mají vlastní příslušné klíče nemohou být uzamykány jako ostatní, prosím. Nejdříve smažte příslušný klíč.
=IDP_DOC_DEMOLOCK(1)	Promiňte!\rDemo verze nemůže otevřít soubory vytvořené licencovaným programem LOCKBASE.
=IDP_DOC_TEMPLATE_ERR(1)	Formát šablony '%s' nelze otevřít.\nSoubor je právě používán jiným uživatelem.
=IDP_DOC_ARCIMAGE(1)	Mají být tyto změny uloženy?
=IDP_DOC_ARCIMAGE_ERR(1)	Zálohování:\nZálohovací soubory úspěšně vytvořeny.\nChyba: Nelze vytvořit obrazový soubor.\nChyba: Nelze vytvořit vstupní hlavičku.\nChyba: Nelze vytvořit vstupní zápis.
=IDP_DOC_SYS_INVEVT(1)	Dané časové období se překrývá s již existujícím rozšířením.
=IDS_DOC_CONSISTENCY_RULES(1)	Byla nalezena zdvojená funkce klíče!\nByla nalezena zdvojená funkce vložky!\nBylo nalezeno zdvojené číslo vložky!\nČíslo příslušného klíče se liší od čísla vložky!\n%u Byly kombinovány vložky uzamykané stejně.\nNebyly nalezeny další sporná data.\nNebyly nalezeny žádná sporná data.
=IDP_DOC_OPENLOCK(1)	Vybraný soubor nelze otevřít touto verzí LOCKBASE.
=IDP_DOC_TEMPLATE_CNF(1)	Všechna formátování tohoto souboru budou nahrazena nastavením v šabloně '%s'.
=IDP_DOC_BRAND_CNF(1)	Změnou značky budou všechny typy vložek neplatné, pokud tyto typy nejsou dostupné v nové značce.\r\rJste si jisti, že chcete změnit značku?
=IDP_DOC_KEYDESTROY(1)	Jste si jisti, že chcete označit klíč jako zničený?
=IDS_DOC_FILESEARCH_RESULT(1)	Soubor\nAdresář
=IDS_DOC_FILESEARCH(1)	V&yhledat|Z&astavit\n%d Nalezené soubory.\nVyhledávání přerušeno.
=IDS_DOC_FILESEARCH_PREVIEW(1)	Systém:\nVlastník:\nZákazník:\nDodavatel:\nTyp:\nZnačka:\nPoprvé:\nNaposledy:\nPoznámky:
=IDS_DOC_FILESEARCH_PROTECTED(1)	[Chráněno heslem]
=IDP_DOC_SEARCH_NOITEMFOUND(1)	Nebyly nalezeny odpovídající záznamy!
=IDP_CYLF_ADDCHGKEYS(1)	Chcete vytvořit příslušné klíče pro vybrané vložky?
=IDP_CYLF_REMCHGKEYS(1)	Chcete smazat všechny příslušné klíče vybraných vložek?
=IDP_MACHINE_FERTECNO(1)	Nastavení pro tento stroj nebylo zadáno kompletně.
=IDS_MACHINE_SILCASSI(2)	Silca SSI Nastavení\n&Značka/Silca Výrobní číslo.:\n&Silca Výrobní číslo.:\n
=IDS_MACHINE_GERAISEL(1)	Gera Isel Nastavení\n&Značka/Karta:\n&Karta:\n
=IDS_MACHINE_GERAHEITEC(1)	Nelze najít ani číslo zakázky nebo typ tisku.\r\rČíslo zakázky nebo typ tisku musí být dostupné v následujícím formátu v poli 'Registrační číslo' Systému Hlavička ('Historie'):\r\r'<Číslo zakázky>/<Typ tisku>', např.\r'P1111V1/001'
=IDS_MACHINE_SILCACSV_HEAD(1)	Kód;Množství;Strana A
=IDS_B2B_EXCHANGE_TXT(1)	Spouštím přenos dat ...\nOdesílání '%s'\nDoručení '%s'\nChyba: '%s'\nPřenos dat přerušen.\nPřenos dat ukončen.
=IDP_B2B_EXCHANGE_ERR(1)	Došlo k chybě během přenosu dat:\nNebylo vytvořeno připojení k internetu.\nNebylo vytvořeno spojení s B2B serverem.\nChyba během čtení ze souboru ('%s').\nChyba během zápisu souboru.\nInvalid confirmation mail receipient - check email address or disable email confirmation\n\n\n\n\nNeznámá chyba (%s).
=IDP_B2B_SETUP(1)	Došlo k chybě během nastavení LOCKBASE B2B:\nSoubor '%s' nelze vytvořit nebo zapsat.\nNeznámá chyba.
=IDP_B2B_SENDERR(1)	Nelze připravit soubor k odeslání.
=IDP_B2B_EXCHANGEERR(1)	Nelze spustit přenos dat.
=IDP_B2B_RECVERR(1)	Nelze otevřít poštovního klienta.
=IDP_B2B_CONFSENDORDER(1)	Jste si jisti, že chcete soubor odeslat jako objednávku?\r\rPo odeslání tento soubor slouží pouze jako kopie a nelze jej měnit, dokud příjemce nepošle odpověď.
=IDP_B2B_CONFSENDREPLY(1)	Jste si jisti, že chcete tento soubor odeslat jako odpověď vlastníkovi??\r\rPo odeslání bude tento soubor odstraněn z vašeho počítače a nebude jej možné měnit ani prohlížet.
=IDP_B2B_NEWMAIL(1)	Máte nový mail.Chcete ho zobrazit nyní?
=IDP_B2B_QUERYEND(1)	LOCKBASE právě vyměňuje data s internetem.Chcete tento proces přerušit?
=IDP_B2B_EXPIRED(1)	Systém generálního klíče vytvořený LOCKBASE-B2B-Matrix musí být vyřízen jako objednávka do 6 měsíců. Pokud se tak nestane, soubor již nepůjde měnit.\r\rToto uzamčení můžete odstranit odesláním souboru jako objednávka výrobci.
=IDP_B2B_WARNEXPIRE(1)	Uvědomte si, že systém generálního klíče vytvořený tímto programem musí být odeslán jako objednávka do 6 měsíců. Pokud se tak nestane, soubor později nepůjde změnit!
=IDP_B2B_CYLTYPEDB(1)	Byla nalezena aktualizace knihovny pro typ vložky.\r\rVýrobce:\t%s\r\rAktualizace bude nyní nainstalována.
=IDP_B2B_PUBKEYAUTH(2)	Autorizační žádost o nový šifrovací klíč byla úspěšně předána na LOCKBASE B2B server.
=IDP_B2B_PUBKEYCERT(1)	Nový šifrovací klíč byl certifikován a vydán do sítě B2B.\r\rNový klíč je nyní aktivní.
=IDP_B2B_PUBKEYREVOKED(1)	Byl získán nový šifrovací klíč pro následující B2B vizitku:\r\r%s\r\rKlíč byl certifikován a od této chvíle může být používán.
=IDS_EDIT_GROUNDPLAN_ADD(1)	Přidat nový půdorys
=IDS_EDIT_GROUNDPLAN_EDIT(1)	Upravit aktuální půdorys
=IDS_EDIT_GROUNDPLAN_DELETE(1)	Vymazat aktuální půdorys
=IDS_WINDOW_FOCUSPREV(1)	Změny do předcházejícího datovém skladu bez jeho aktivace.
=IDS_WINDOW_FOCUSNEXT(1)	Změny do následujícího datového skladu bez jeho aktivace.
=IDS_OPTIONS_UADMIN(1)	Otevřít nebo aktivovat Správu uživatelů
=IDS_OPTIONS_CREATOR(1)	Aktivovat možnost k použití Asistenta vytvoření při vytváření nového systému generálního klíče
=IDS_OPTIONS_CTDBDOC(1)	Aktivovat možnost k zobrazení nápovědy pro každý typ vložky, zatím co se vytváří nebo mění datové skupiny
=IDS_OPTIONS_B2B_ADMIN(1)	Otevřít dialogové okno ke správě B2B vizitek
=IDS_EDIT_SORT(1)	Třídění datových skupin v nesetříděném zobrazení
=IDS_FILE_C2B(1)	Vytváření klientského programu pro objednání systému generálního klíče přes internet
=IDP_CISA_CODE_1(1)	Číslo systému je dočasný kód. Chcete přiřadit číslo systému CISA nyní?
=IDP_CISA_CODE_2(1)	Číslo systému: %s\rNový název souboru: %s\rZměnit?
=IDP_CISA_CODE_ERR(1)	Soubor'%s' již existuje.
=IDS_EVENTS_DESCRIPTIONS(1)	\nVýdej klíče\nPříjemn klíče\nMontáž vložky\nDemontáž vložky
=IDP_USERS_ERR_NAME(1)	Dané uživatelské jméno je špatné.\r\rNesmí být další uživatel se stejným jménem, jméno musí být nejméně 1 znak dlouhé a nesmí obsahovat mezery.
=IDP_USERS_ERR_PASS(1)	Heslo je špatné.\r\rHeslo musí být nejméně 3 znaky dlouhé a nesmí obsahovat mezery.
=IDP_USERS_ERR_RETYPE(1)	Heslo a jeho ověření jsou rozdílné.
=IDP_USERS_CNF_REMOVE(1)	Opravdu chcete odstranit tohoto uživatele?
=IDP_USERS_CNF_DISABLE(1)	Opravdu chcete vypnout Správu uživatelů?\r\rUvědomte si, že s vypnutou správou uživatelů má každý uživatel neomezený přístup ke všem datům, prosím.
=IDP_USERS_DISABLE(1)	správa uživatelů byl vypnuta.\r\rNyní mají všichni uživatelé neomezený přístup ke všem datům.\r\rK opětovnému zapnutí, vyberte v menu příkaz 'Správa uživatelů...' a po té restartujte LOCKBASE.
=IDP_USERS_CNF_ENABLE(1)	Správa uživatelů není aktivní.\r\rChcete ji aktivovat nyní?
=IDP_USERS_ENABLE(1)	Správa uživatelů bude zapnuta při dalším spuštění LOCKBASE.\r\rUkončete program k projevení provedených změn, prosím.
=IDP_USERS_ERR_LOGIN(1)	Uživatel je neznámý nebo je špatné heslo.\r\rLOCKBASE vás nemůže přihlásit.
=IDP_USERS_ERR_OLDPWD(1)	Staré heslo není platné.
=IDP_USERS_CHGPWD(1)	Heslo pro uživatele '%s' bylo změněno.
=IDS_USERS_INSTRUCT(1)	Správa uživatelů je spuštěna.\nVložte uživatelské jméno a heslo pro hlavního správce:|K přihlášení do LOCKBASE, zadejte vaše uživatelské jméno a heslo do následujících polí:|Pro změnu vašeho hesla, vložte níže jako první vaše staré heslo a poté nové:
=IDS_USERS_RIGHTS(1)	Zobrazení:0-3:Datové sklady;Systém Matrix;Kalkulátor;Systém Návrhář\nDatové přístupy:10-12:Změny systémů;Technická data;Změny kalkulovaných systémů\nExtra:50-52:Strojní rozhraní;Datová výměna přes internet (B2B);Stahovat a instalovat aktualizace
=IDS_UPDATE_TXT0(1)	LOCKBASE ověřuje dostupné aktualizace pro tuto instalaci\\LOCKBASE webový server není dostupný.\n\nStiskněte 'Další >>' ke spuštění nebo 'Zrušit' k přerušení.\n\nK vypnutí funkce automatické aktualizace 'O LOCKBASE...' v menu Nápovědy a deaktivujte ověřovací okno 'Ověřit aktualizace automaticky ...'.
=IDS_UPDATE_TXT1(1)	\nspojování s LOCKBASE webovým serverem ...
=IDS_UPDATE_TXT2(1)	Je dostupná následující aktualizace:\n\n%s\n\nStiskněte 'Další >>' ke stažení a instalaci aktualizace nyní nebo 'Zrušit' k přerušení.
=IDS_UPDATE_TXT3(1)	Žádná aktualizace není dostupná.\n\nNa vašem počítači běží poslední verze. Stiskněte 'Zrušit' k ukončení tohoto dialogu.
=IDS_UPDATE_TXT4(1)	LOCKBASE stahuje následující aktualizace:\n\n%s\n\nStahuji 
=IDS_UPDATE_TXT5(1)	Stahování bylo úspěšně dokončeno.\n\nLOCKBASE se ukončí a spustí instalační program aktualizace.\n\nstiskněte 'Další >>' ke spuštění nebo 'Zrušit' k přerušení instalace.
=IDS_UPDATE_TXT6(1)	Došlo k chybě během automatické aktualizace. Aktualizace nebyla naistalována.\n\nStiskněte 'Zrušit' k ukončení dialogu.
=IDS_UPDATE_TXT7(1)	Automatická aktualizace byla přerušena. Aktualizace nebyla nainstalována.\n\nStiskněte 'Zrušit' k ukončení dialogu.
=IDP_UPDATE_ERRWEB(1)	Nebylo vytvořeno připojení k internetu.\n\nPokud tento počítač nemá přístup k internetu, není možné použít LOCKBASE aktualizační servis.
=IDP_UPDATE_ERRSITE(1)	LOCKBASE webový server je momentálně nedostupný.
=IDP_UPDATE_ERRPASS(1)	Nebylo zadáno heslo podpory nebo je heslo špatné.\n\nV menu nápovědy LOCKBASE vyberte příkaz 'O LOCKBASE...' a vložte správné heslo.\nHeslo podpory najdete v licenčních dokumentech nebo jej obdržíte od vašeho distributora LOCKBASE.
=IDP_UPDATE_ERRTMP(1)	Aktualizace nemůže být u,ložena na lokální pevný disk tohoto počítače.\n\nLOCKBASE uloží aktualizaci do dočasného souboru a proto potřebuje přístup zápisu a dostatečné místo na disku v adresáři temp.
=IDP_UPDATE_CNFCANCEL(1)	Chcete přerušit\nLOCKBASE Aktualizační servis?
=IDS_PRTFX_COVERSHEET(1)	Historie
=IDS_PRTFX_MATRIXPRN(1)	Centrální vložka|&Na šířku|&Zobrazit položky v uvedeném postupu|&Skrýt uzamykané stejně|&Rozvržení*Klíče nahoře*Vložky nahoře*Euro Matrix*Cylinder groups|&Scaling factor (%)
=IDS_PRTFX_PINNINGLIST(2)	&Rozpis stavítek kumulativně|&Kombinovat uzamykané stejně|&Zobrazit položky v uvedeném postupu|&Vložky na řádku|V&yhodnotit množství vložek|&Minimální linie pro stavítka
=IDS_PRTFX_LETTER(1)	Písemný text|Adresy|Datum|Systém|Značka|(Místo, Datum)|(Podpis)|Množství|&Okno pro množství|&Adresy na (mm)|&Název na (mm)
=IDS_PRTFX_KEYSTOCK(1)	Podpis|&Tisk pole podpisu|&Sklad klíčů*Všechny*Aktuální*Dostupné*Vydané*Zničené
=IDS_PRTFX_ASSEMBLY(1)	Stavítka|Mezistavítka|Top stavítek|Klíč|Typ|Profil|Počet|Typ vložky|Zvláštní úpravy|Povrch|Délka|Item code|Type description|Délky bubínků a typy|Generální klíče|Skupinové klíče|Skupinové klíče|Skupinové klíče|Příslušné klíče|Cena|Celcem|Celková hodnota|Celková cena|&Rozpis stavítek|&Počet klíčů|R&ozměr vložek a typy|&Tisknout bubínky odděleně|Print &item codes
=IDP_PRN_SELECTDLG_CNF_REMFORM(1)	Opravdu chcete smazat tento tiskopis?
=IDP_PRN_SELECTDLG_CNF_ADDFORM(1)	Chcete vytvořit kopii tohoto formuláře?
=IDP_PRN_SELECTDLG_ERR_PRINTER(1)	Je nastaveno několik tiskáren.\r\rZvolte nově (výchozí) tiskárnu nebo změňte výběr a tiskněte v několika krocích na různých tiskárnách.
=IDP_PRN_SELECTDLG_ERR_LABELS(1)	Formuláře etiket musí být tištěny individuálně.\r\rZvolte buď jednu etiketu nebo odstraňte všechny formuláře etiket z výběru.
=IDS_PRTFX_BITTINGLIST(1)	&Zobrazit položky v uvedeném postupu|&Vždy zobrazovat pořadová čísla kopií klíčů
=IDS_PRTFX_CTRLKEYLIST(1)	Kontrola klíče|vložek
=IDS_PRTFX_COMBIPINNINGLIST(1)	&Rozpis stavítek kumulativně|&Zobrazit položky v uvedeném postupu|&Kombinovat uzamykané stejně
=IDS_PRTFX_DOUBLELIST(1)	Zobrazit položky v uvedeném postupu
=IDS_PRTFX_SINGLELIST(1)	&Zobrazit položky v uvedeném postupu
=IDS_PRTFX_TECHCHOICE(1)	&Technology*All*Mechanic*Mechatronic*Electronic
=IDP_CYLTYPEDB_SCANERR(1)	Chyba během načítání typu vložek souboru '%s', řádku %d, sloupce %d. Načítání bylo přerušeno.
=IDP_C2B_ERROR(1)	Došlo k chybě během vytváření objednávky (C2B).\nProgram nelze vytvořit do složky LOCKBASE.\nSoubor '%s' chybí nebo je poškozen.\nNelze zapsat '%s'.\nSoubor, který slouží jako šablona, nebyl nalezen ('LbwC2B.lbt').\nB2B modul není připraven.
=IDP_C2B_SUCCESS(1)	Objednávka byla úspěšně vytvořena programem (C2B).\n\rSoubor '%s' byl používán jako šablona dokumentu.\r\rKaždopádně doporučujeme vytvořit vlastní šablonu pro objednání programem a uložit pod jménem 'LbwC2B.lbt' ve složce LOCKBASE.
=IDP_CYL_INVEXTRA(1)	Zvláštní úpravy '%s' jsou vadné.
=IDP_CYL_USERDEFTYPE(1)	The cylinder type entered is unknown.\rShould this type be used anyway?
=IDP_CYL_BLINDERR(1)	The choosen cylinder type is a dummy cylinder.\nDummy cylinders can't be locked by keys nor be keyed alike.\nFor this reason the choosen type can't be used for the selectet cylinders.
=IDP_EXCHG_CSVSEL_CNFDEL(1)	Opravdu chcete smazat %s formát specifikací?
=IDP_EXCHG_CSVFRM_CNFDEL(1)	Opravdu chcete smazat zdrojová data '%s'?
=IDP_EXCHG_CSVFRM_ERRINVCELL(1)	Neplatný název buňky '%s' .\n\nPlatný název buňky je kombinace znaků definující sloupec, následován decimálním číslem definujícím řadu, např. 'A3' nebo 'AFB128'.\n\nK definování místa zdrojových dat, která dosahují konce (variabilního) tabulky, nechte pole pro poslední buňku prázdné.
=IDP_EXCHG_CSVFRM_ERRINVAREA(1)	Obsah zdrojových dat '%s' je vadný.\n\nRozsah obsahu zdrojových dat je omezena jednu řadu nebo sloupec, tj. sloupec nebo řada na začátku i konci buňky musí být stejný, např. 'A2-A55' nebo 'B12-H12', ale ne 'B12-H14'.
=IDP_EXCHG_CSVFRM_ERRBASEFIELD(1)	Pro základní typ musí být vybráno pole.
=IDP_EXCHG_CSVFRM_ERRBASEAREA(1)	Pro hlavní datové typy musí být definován obsah zdrojových dat.
=IDP_EXCHG_CSVFRM_ERRTARGETAREA(1)	Pro cílová data musí být definován obsah zdrojových dat.
=IDS_EXCHG_POS(1)	[Pozice]
=IDP_EXCHG_ERRLOADFILE(1)	chyba během čtení souboru '%s':\nSoubor nelze načíst.
=IDP_EXCHG_ERRINVFORMAT(1)	Chyba v následujícím formátu specifikací:\n'%s'\n%s
=IDP_EXCHG_ERRSTOREFILE(1)	Error writing file '%s':\nThe file could not be stored.
=IDP_EXCHG_ERRINVDATAEXP(1)	Data were found, which do not meet the export format definition: %s
=IDS_EDIT_SEARCH(1)	Searches for a given word in the data fields of a record list\nSearches for a given word in the data fields of a record list
=IDS_FILE_ORDERS_NEW(1)	Creates a new order and opens it for editing\nCreates a new order and opens it for editing
=IDS_FILE_ORDERS_VIEW(1)	Opens the order management dialog\nOpens the order management dialog
=IDS_FILE_ORDERS_CLOSE(1)	Finish the work at the current order and close the order\nFinish the work at the current order and close the order
=IDS_OPTIONS_MTRX_SETUP(1)	Open the dialogue to setup the System Matrix
=IDS_EDIT_COPY_COL(1)	Copy selected columns to the clipboard\nCopy selected columns to the clipboard
=IDS_EDIT_PASTE_COL(1)	Import columns from the clipboard\nImport columns from the clipboard
=IDS_EDIT_COPY_LINE(1)	Copy selected lines to the clipboard\nCopy selected lines to the clipboard
=IDS_EDIT_PASTE_LINE(1)	Import lines from the clipboard\nImport lines from the clipboard
=IDS_OPTIONS_KEYSUP(1)	Shows the System Matrix in regular display mode (Keys up)
=IDS_OPTIONS_CYLSUP(1)	Shows the System Matrix in regular display mode (Cylinders up)
=IDS_OPTIONS_CYLGROUPS(1)	Displays the system matrix combined by cylinder groups (cylinder groups, superordinated keys, central cylinders)
=IDS_OPTIONS_KEEPPRINTOPEN(1)	Keeps the print selection dialogue open after print
=IDS_OPTIONS_LBT(1)	Define the settings for the format template
=IDS_EDIT_COPY(1)	Copy selected records to the clipboard
=IDS_EDIT_PASTE(1)	Import records from the clipboard
=IDP_DOC_CYLNOTFOUND(1)	A cylinder with the number '%s' was not found (the cylinder must be a member of the current sub group).
=IDP_DOC_SYS_CUSTREM(1)	You haven't entered any customer information.\n\nShould this customer be removed from the database?
=IDS_DOC_OPTIMIZE(1)	File optimization in progress... (%u%%)
=IDS_STRFRM_CYLGROUP(1)	\nGroup\nDescription\nAvailable\nPlanned\nCylinders\n
=AFX_IDS_OPENFILE(1)	Otevřít
=AFX_IDS_SAVEFILE(1)	Uložit jako
=AFX_IDS_ALLFILTER(1)	Všechny soubory (*.*)
=AFX_IDS_UNTITLED(1)	Stornovat
=AFX_IDS_HIDE(1)	&Skrýt
=AFX_IDS_MEMORY_EXCEPTION(1)	Mimo paměť.
=AFX_IDS_NOT_SUPPORTED_EXCEPTION(1)	Nepodporovaná operace byla přerušena.
=AFX_IDS_RESOURCE_EXCEPTION(1)	Požadované prostředky nejsou povoleny.
=AFX_IDS_USER_EXCEPTION(1)	Vyskytla se neznámá chyba.
=AFX_IDP_INVALID_FILENAME(1)	Neplatný název souboru.
=AFX_IDP_FAILED_TO_OPEN_DOC(1)	Dokument se nepodařilo otevřít.
=AFX_IDP_FAILED_TO_SAVE_DOC(1)	Dokument se nepodařilo uložit.
=AFX_IDP_ASK_TO_SAVE(1)	Uložit změny %1?
=AFX_IDP_FAILED_TO_CREATE_DOC(1)	Prázdný dokument se nepodařilo vytvořit.
=AFX_IDP_FILE_TOO_LARGE(1)	Soubor je příliš velký pro otevření.
=AFX_IDP_FAILED_TO_START_PRINT(1)	Nelze začít tisknout.
=AFX_IDP_FAILED_TO_LAUNCH_HELP(1)	Nepodařilo se spustit nápovědu.
=AFX_IDP_INTERNAL_FAILURE(1)	Interní chyba aplikace.
=AFX_IDP_COMMAND_FAILURE(1)	Špatný příkaz.
=AFX_IDP_FAILED_MEMORY_ALLOC(1)	Nedostatek paměti pro spuštění operace.
=AFX_IDP_GET_NOT_SUPPORTED(1)	Nelze načíst data určená k zápisu.
=AFX_IDP_SET_NOT_SUPPORTED(1)	Nelze uložit data pouze ke čtení.
=AFX_IDP_UNREG_DONE(1)	Položky v registru systému byly odstraněny a soubor *.ini (pokud není žádný) byl smazán.
=AFX_IDP_UNREG_FAILURE(1)	Nebyly odstraněny všechny položky v registru systému (nebo soubor *.ini).
=AFX_IDP_DLL_LOAD_FAILED(1)	Tento program vyžaduje soubor %s, který nebyl nalezen v systému.
=AFX_IDP_DLL_BAD_VERSION(1)	Tento program je propojen na chybějící export %s v souboru %s. Tento počítač může mít nekompatibilní verzi %s.
=AFX_IDP_FAILED_INVALID_FORMAT(1)	Nepodporovaný formát souboru.
=AFX_IDP_FAILED_INVALID_PATH(1)	%1\nNelze najít tento soubor.\nProsím, ověřte nastavení cesty a název souboru.
=AFX_IDP_FAILED_DISK_FULL(1)	Cílová disketová jednotka je plná.
=AFX_IDP_FAILED_ACCESS_READ(1)	Soubor nelze načíst %1, je používán jiným uživatelem.
=AFX_IDP_FAILED_ACCESS_WRITE(1)	Změny nebudou uloženy %1, soubor je otevřen pouze pro čtení nebo používám jiným uživatelem.
=AFX_IDP_FAILED_IO_ERROR_READ(1)	Neočekávaná chyba během otevírání souboru %1.
=AFX_IDP_FAILED_IO_ERROR_WRITE(1)	Neočekávaná chyba během ukládání souboru %1.
=AFX_IDP_PARSE_INT(1)	Vložte celé číslo, prosím.
=AFX_IDP_PARSE_REAL(1)	Vložte číslo, prosím.
=AFX_IDP_PARSE_INT_RANGE(1)	Vložte celé číslo v rozmezí %1 a %2, prosím.
=AFX_IDP_PARSE_REAL_RANGE(1)	Vložte číslo v rozmezí %1 a %2, prosím.
=AFX_IDP_PARSE_STRING_SIZE(1)	Nevkládejte více než %1 znak, prosím.
=AFX_IDP_PARSE_STRING_EMPTY(1)	Toto pole nesmí být prázdné.
=AFX_IDP_PARSE_RADIO_BUTTON(1)	Vyberte tlačítko, prosím.
=AFX_IDP_PARSE_BYTE(1)	Vložte celé číslo mezi 0 a 255, prosím.
=AFX_IDP_PARSE_UINT(1)	Vložte celé kladné číslo, prosím.
=AFX_IDP_PARSE_DATETIME(1)	Vložte datum a/nebo čas, prosím.
=AFX_IDP_PARSE_CURRENCY(1)	Vložte hodnotu, prosím.
=AFX_IDS_PASTELINKEDTYPE(1)	Propojeno s %s
=AFX_IDS_UNKNOWNTYPE(1)	Neznámý typ
=AFX_IDP_FAILED_TO_NOTIFY(1)	%1\nDocument nelze zaregistrovat.\nDokument již  může být otevřen.
=AFX_IDS_NOT_DOCOBJECT(1)	Formát souboru není podporován jako dokument cílového serveru.
=AFX_IDP_NO_ERROR_AVAILABLE(1)	Chybové hlášení není dostupné.
=AFX_IDP_FILE_NONE(1)	Nenastala chyba.
=AFX_IDP_FILE_GENERIC(1)	Během přístupu nastala neznámá chyba %1.
=AFX_IDP_FILE_NOT_FOUND(1)	%1 nebyl nalezen.
=AFX_IDP_FILE_BAD_PATH(1)	%1 Neplatná cesta.
=AFX_IDP_FILE_TOO_MANY_OPEN(1)	%1 nelze otevřít, protože je otevřeno příliš mnoho souborů.
=AFX_IDP_FILE_ACCESS_DENIED(1)	Přístup k %1 byl zamítnut.
=AFX_IDP_FILE_INVALID_FILE(1)	Chybné zpracování souboru bylo vyvoláno %1.
=AFX_IDP_FILE_REMOVE_CURRENT(1)	%1 nemůže být přemístěn do stejného adresáře.
=AFX_IDP_FILE_DIR_FULL(1)	%1 nemůže být vytvořen, jelikož adresář je plný.
=AFX_IDP_FILE_BAD_SEEK(1)	Vyhledávání neúspěšné %1
=AFX_IDP_FILE_HARD_IO(1)	Technické selhání I/O během přístupu %1.
=AFX_IDP_FILE_SHARING(1)	Narušené sdílení během přístupu %1.
=AFX_IDP_FILE_LOCKING(1)	Blokování narušení během přístupu %1.
=AFX_IDP_FILE_DISKFULL(1)	Disk zaplněn během přístupu %1.
=AFX_IDP_FILE_EOF(1)	Pokus o přístup %1 za jeho koncem.
=AFX_IDS_UNNAMED_FILE(1)	Neznámý soubor
=AFX_IDP_ARCH_NONE(1)	Nenastala chyba.
=AFX_IDP_ARCH_GENERIC(1)	Došlo k neznámé chybě během přístupu %1.
=AFX_IDP_ARCH_READONLY(1)	Pokus o zápis během čtení %1.
=AFX_IDP_ARCH_ENDOFFILE(1)	Pokus o přístup %1 za jeho koncem.
=AFX_IDP_ARCH_WRITEONLY(1)	Pokus o zápis během čtení %1.
=AFX_IDP_ARCH_BADINDEX(1)	%1 je ve špatném formátu.
=AFX_IDP_ARCH_BADCLASS(1)	%1 obsahuje neočekávaný objekt.
=AFX_IDP_ARCH_BADSCHEMA(1)	%1 obsahuje nesprávné schéma.
=AFX_IDP_FAILED_MAPI_LOAD(1)	Nelze načíst poštovního klienta podporu.
=AFX_IDP_INVALID_MAPI_DLL(1)	Knihovna DLL poštovního klienta je vadná.
=AFX_IDP_FAILED_MAPI_SEND(1)	Odeslání zprávy poštovním klientem selhalo.
=AFX_IDS_OCC_SCALEUNITS_PIXELS(1)	pixely
=AFX_IDS_PRINTONPORT(1)	na %1
=AFX_IDS_ONEPAGE(1)	&Jedna strana
=AFX_IDS_TWOPAGE(1)	&Dvě strany
=AFX_IDS_PRINTPAGENUM(1)	Strana %u
=AFX_IDS_PREVIEWPAGEDESC(1)	Strana %u\nStrany %u-%u\n
=AFX_IDS_PRINTDEFAULTEXT(1)	prn
=AFX_IDS_PRINTDEFAULT(1)	Výstup.prn
=AFX_IDS_PRINTFILTER(1)	Printer Files (*.prn)|*.prn|Všechny soubory (*.*)|*.*||
=AFX_IDS_PRINTCAPTION(1)	Tisk do souboru
=AFX_IDS_PRINTTOFILE(1)	do %1

=IDD_INSTALL(1)	Nastavení LOCKBASE
=IDD_INSTALL_BUTTON_BACK(1)	<< &Zpět
=IDD_INSTALL_CANCEL(1)	Zrušit
=IDD_INSTALL_STATIC1(1)	Vítejte v instalačním programu LOCKBASE.\n\nSpustit instalaci LOCKBASE na vašem počítači.
=IDD_INSTALL_STATIC2(1)	Zavřete prosím všechny spuštěné aplikace a stiskněte 'Další >>'jakmile budete připraveni.\n\nPokud nechcete LOCKBASE nainstalovat, stiskněte 'Zrušit'.
=IDD_INSTALL_STATIC_TAB1(1)	Licenční ujednání a podmínky
=IDD_INSTALL_STATIC3(1)	Věnujte pozornost následujícím licenčním ujednáním a podmínkám. V souladu s licenčními ujednáními, aktivujte kontrolní okénko 'Souhlasím'. Poté stiskněte 'Další >>' k pokračování instalace. 
=IDD_INSTALL_CHECK_CONTRACT(1)	&Souhlasím
=IDD_INSTALL_STATIC_TAB2(1)	Aktualizace
=IDD_INSTALL_STATIC4(1)	LOCKBASE je již instalována na vašem počítači.\nVyberte, prosím instalaci, jež chcete aktualizovat a poté stiskněte 'Další >>'.
=IDD_INSTALL_STATIC5(2)	LOCKBASE bude nainstalována do adresáře uvedeného níže. Stiskněte prosím 'Změnit...' k výběru jiného místa.\n\nPoznámka: Síťová verze by měla být instalována ve sdílené složce na serveru. Tímto mohou všichni uživatelé programu sdílet data.\n\nPro registraci Lockbase na jiném stanovišti, jednoduše spusťte Lbw.exe ze sdílené složky.
=IDD_INSTALL_STATIC_PATH1(2)	LOCKBASE bude nainstalována do následujícího adresáře:\n\nProgram files:\t%s\nData files:\t%s
=IDD_INSTALL_STATIC_ACTION(1)	Kopíruji %s ...|Zápis LOCKBASE ...
=IDD_INSTALL_STATIC_PATH2(1)	Aktualizace instalace v adresáři \n\n%s\n\nbyla úspěšně dokončena.\n\nStiskněte, prosím, 'Zavřít' k ukončení nastavení.
=IDD_INSTALL_STATIC_PATH3(2)	LOCKBASE byla úspěšně instalována v adresáři\n\nProgram files:\t%s\nData files:\t%s
=IDD_INSTALL_STATIC8(2)	Při prvním spuštění programu na každém počítači musíte zaregistrovat LOCKBASE pro tyto pracovní stanice. Proto budete požádání o vložení licenčního klíče odpovídajícímu danému uživatelskému klíči.\n\nPro získání licenčního klíče kontaktujte distributora Lockbase.\n\nStiskněte "Zavřít" pro ukonční nastavení.
=IDD_INSTALL_STATIC_TAB3(1)	Nová Instalace
=IDD_INSTALL_STATIC_TAB4(1)	Instalace
=IDD_INSTALL_STATIC_TAB6(1)	Instalace dokončena
=IDD_INSTALL_STATIC_TAB5(1)	Aktualizace dokončena
=IDD_INSTALL_STATIC10(1)	Pokud tak již není, nastavení vytvoří odkaz pro LOCKBASE v menu Start a zástupce na ploše.
=IDD_INSTALL_STATIC11(1)	Stiskněte, prosím 'Spustit' ke spuštění instalačního procesu.

=IDD_UNINSTALL(1)	Nastavení LOCKBASE
=IDD_UNINSTALL_CANCEL(1)	Zrušit
=IDD_UNINSTALL_STATIC_PATH1(2)	LOCKBASE bude odstraněna z následujícího adresáře:\n\n%s\n\nOdkaz v menu Start a zástupce na ploše této instalace bude odstraněn.\n\nProsím, stiskněte 'Spustit' k zahájení deinstalace.
=IDD_UNINSTALL_STATIC_ACTION(1)	Odstraňuji soubory ...|Odstranění zápisu ...
=IDD_UNINSTALL_STATIC_TAB0(1)	Existující instalace
=IDD_UNINSTALL_STATIC1(1)	Nastavení našlo následující instalace na vašem počítači.\nProsím, vyberte instalaci, kterou chcete odstranit, poté stiskněte 'Další >>'.
=IDD_UNINSTALL_BUTTON_BACK(1)	<< &Zpět
=IDD_UNINSTALL_STATIC_TAB1(1)	Odinstalace
=IDD_UNINSTALL_STATIC_TAB2(1)	Odinstalace dokončena
=IDD_UNINSTALL_STATIC_PATH2(2)	LOCKBASE byla úspěšně odinstalována z adresáře\n\n%s.
=IDD_UNINSTALL_STATIC2(1)	Prosím, stiskněte 'Zavřít' k ukončení nastavení.
=IDD_UNINSTALL_STATIC_FILESLEFT(1)	Adresář nelze odstranit, protože stále obsahuje soubory vytvořené uživatelem. Nicméně, adresář můžete odstranit manuálně po uložení těchto souborů.


=IDD_B2B_SETUP_1(2)	LOCKBASE B2B - Nastavení (1)
=IDD_B2B_SETUP_1_STATICTXT1(1)	Před prvním přenosem souboru LOCKBASE musí být vytvořena 'vizitka'pro vaši společnost.\nTato vizitka obsahuje vaše adresy a šifrovací klíč k zajištění bezpečného přenosu souborů přes internet.
=IDD_B2B_SETUP_1_STATICTXT2(1)	Vyplňte kompletní adresu vaší společnosti ve formuláři níže. Pole označená * jsou povinná.
=IDD_B2B_SETUP_1_STATICTXT3(1)	*&Společnost:
=IDD_B2B_SETUP_1_STATIC_NAME2(1)	&Dodatek:
=IDD_B2B_SETUP_1_STATICTXT4(1)	*&Ulice:
=IDD_B2B_SETUP_1_STATICTXT5(1)	*&Směrovací číslo:
=IDD_B2B_SETUP_1_STATICTXT6(1)	*&Město:
=IDD_B2B_SETUP_1_STATICTXT7(1)	Z&emě:
=IDD_B2B_SETUP_1_STATICTXT8(1)	Následující zkrácené jméno společnosti se objeví u příjemce v seznamu pošty:
=IDD_B2B_SETUP_1_STATICTXT9(1)	*Zkrácené &jméno:

=IDD_B2B_SETUP_2(2)	LOCKBASE B2B - Nastavení (2)
=IDD_B2B_SETUP_2_STATICTXT1(1)	LOCKBASE používá veřejné šifrovací klíče o ochraně výměny dat přes internet
=IDD_B2B_SETUP_2_STATICTXT2(1)	K vytvoření a 'dobré'řady šifrovacího klíče jsou vyžadovány 'reálná' náhodná čísla.
=IDD_B2B_SETUP_2_STATICTXT3(1)	Pohybujte dokola kursorem myši nad tímto oknem dokud displej nedosáhne hodnoty 100%.
=IDD_B2B_SETUP_2_STATIC_MSG(1)	Díky, vaše 'vizitka'je připravena k vytvoření. Vyberte 'Další' ke spuštění vytvoření.

=IDD_B2B_SETUP_3(2)	LOCKBASE B2B - Nastavení (3)
=IDD_B2B_SETUP_3_STATICTXT1(1)	Vizitka je připravena k vytvoření. Zkontrolujte vložená data a stiskněte 'Dokončit' pokud jsou v pořádku.
=IDD_B2B_SETUP_3_STATIC_MSG(1)	Vytvářím šifrovací klíč\nVaše 'vizitka' byla úspěšně vytvořena.
=IDD_B2B_SETUP_3_STATIC_ADDRESS(1)	Adresa:
=IDD_B2B_SETUP_3_STATICTXT2(1)	Zkrácený název:

=IDD_B2B_SEND(1)	LOCKBASE B2B - Odeslání souboru
=IDD_B2B_SEND_STATICTXT1(1)	&Příjemce:
=IDD_B2B_SEND_STATICTXT2(1)	P&ředmět:
=IDD_B2B_SEND_STATICTXT3(1)	&Dopis:
=IDD_B2B_SEND_BUTTON_DEFAULT(1)	&Šablona
=IDD_B2B_SEND_STATICTXT4(1)	S&oubor:
=IDD_B2B_SEND_BUTTON_FILE(1)	&Vybrat ...
=IDD_B2B_SEND_CHECK_REPLY(1)	&Potvrzení e-mailem:
=IDD_B2B_SEND_OK(1)	Odeslat
=IDD_B2B_SEND_CANCEL(1)	Zrušit

=IDD_B2B_RECV(1)	LOCKBASE B2B - Přijmutí souborů
=IDD_B2B_RECV_STATICTXT1(1)	&Příchozí pošta:
=IDD_B2B_RECV_STATICTXT2(1)	&Odesílatel:
=IDD_B2B_RECV_STATICTXT3(1)	P&ředmět:
=IDD_B2B_RECV_STATICTXT4(1)	D&atum/Čas:
=IDD_B2B_RECV_STATICTXT5(1)	&Dopis:
=IDD_B2B_RECV_STATICTXT6(1)	&Soubor:
=IDD_B2B_RECV_BUTTON_UNPACK(1)	&Rozbalit
=IDD_B2B_RECV_OK(1)	Zavřít

=IDD_B2B_SETUP_R1(2)	LOCKBASE B2B - Nastavení (1)
=IDD_B2B_SETUP_R1_STATICTXT1(1)	Tento asistent vám pomůže vytvořit nový šifrovací klíč pro vaši vlastní vizitku. Ten je nutný v případě, že se obáváte zneužití osobního klíče neoprávněnou osobou.
=IDD_B2B_SETUP_R1_STATICTXT2(1)	Z bezpečnostních důvodů musí být výměna klíče autorizována.Proto je výměna prováděna ve třech krocích:
=IDD_B2B_SETUP_R1_STATICTXT3(1)	1. Použitím tohoto asistenta vytvoříte nový šifrovací klíč, jehož veřejná část bude společně se žádostí o autorizaci odeslána na LOCKBASE B2B server (bude uděláno automaticky programem LOCKBASE).
=IDD_B2B_SETUP_R1_STATICTXT4(1)	2. Körtner && Muth GmbH vás zkontaktuje a ověří identitu porovnáním jeho 'otisku prstu' (bezpečnostní kontrolní součet).
=IDD_B2B_SETUP_R1_STATICTXT5(1)	3. Pokud je ověření úspěšné, váš nový veřejný klíč bude elektronicky označen a bude uveřejněn pro stahování v B2B síti.
=IDD_B2B_SETUP_R1_STATICTXT6(1)	Varování: Autorizační proces je zpoplatněn! Pokud nechcete vytvořit nový šifrovací klíč, musíte tento proces zrušit nyní.

=IDD_B2B_ADMIN(1)	LOCKBASE B2B - Administrace Vizitek
=IDD_B2B_ADMIN_STATICTXT1(1)	&Vizitky:
=IDD_B2B_ADMIN_LIST1(1)	Identifikátor\tZkrácený název
=IDD_B2B_ADMIN_STATICTXT2(1)	&Identifikátor:
=IDD_B2B_ADMIN_STATICTXT3(1)	&Zkrácený název:
=IDD_B2B_ADMIN_STATICTXT4(1)	&Adresa:
=IDD_B2B_ADMIN_STATICTXT5(1)	V&ytvořeno u:
=IDD_B2B_ADMIN_STATICTXT6(1)	V&eřejný klíč:\n(Otisk prstu)
=IDD_B2B_ADMIN_STATICTXT7(1)	&Vyv&olané karty:
=IDD_B2B_ADMIN_LIST2(1)	Identifikátor\tVytvořeno\tZkrácený název
=IDD_B2B_ADMIN_OK(1)	Zavřít
=IDD_B2B_ADMIN_BTN_NEW(1)	&Nahradit...
=IDD_B2B_ADMIN_BTN_REMOVE(1)	Od&stranit

=IDS_B2B_SETUP_CAPTION(1)	LOCKBASE B2B - Nastavení
=IDS_B2B_SETUP_CLOSE(1)	&Zavřít
=IDP_B2B_SETUP_KEYREPL(1)	Vytvořili jste nový šifrovací klíč pro vaši 'vizitku' a spustili žádost o autorizaci.\nOvěřená data vaší nové vizitky jsou:\n\nId karty:\t%s\nOtisk prstu:\t%s\n\nJakmile bude autorizace ukončena, váš nový veřejný klíč bude uveřejněn v síti B2B.\nProveďte datovou výměnu B2B s internetem ke zjištění, zda autorizace byla ukončena úspěšně.
=IDP_B2B_SEND_SAVE_LETTER(1)	Má být dopis uložen jako šablona pro další dopisy tomuto příjemci?
=IDP_B2B_SEND_LETTER_SAVED(1)	Dopis byl uložen jako šablona.
=IDP_B2B_SEND_ERR(1)	Soubor '%s' byl úspěšně připraven k odeslání.\nDošlo k chybě během přípravy souboru '%s' pro odeslání:\nNeznámý příjemce.\nSoubor nebyl nalezen.\nSoubor nelze načíst.\nVýstupní soubor nelze vytvořit.\nNeznámá chyba.
=IDP_B2B_SEND_NOTEXT(1)	Při tvorbě dopisu příjemci je doporučeno zadat přinejmenším Předmět.\n\nOpravdu chcete soubor takto odeslat ?
=IDP_B2B_SEND_NOFILE(1)	Žádný soubor k odeslání.
=IDS_B2B_SEND_SENDING(1)	Příprava odeslání
=IDP_B2B_SEND_NOEMAIL(1)	E-mailová adresa je neplatná nebo chybí.\n\nPokud nechcete e-mailové potvrzení, deaktivujte příslušný kontrolní rámeček.
=IDS_B2B_SEND_EXCH(1)	Odesílám data
=IDP_B2B_SEND_EXCH_ERR(1)	Soubor '%s' byl úspěšně přenesen.\nChyba během odesílání souboru'%s':\n'%s'\nNebylo vytvořeno připojení k internetu.\nSpojení k B2B serveru nebylo vytvořeno.\nNeznámá chyba.
=IDP_B2B_SEND_WARN_OWNER(1)	The selected receipient is not the owner of this file.\n\nAre you sure to send this file to the selected receipient?
=IDS_B2B_RECV_OPENING(1)	Otevření obálky
=IDP_B2B_RECV_OPENERR(1)	Došlo k chybě během otvírání souboru '%s':\nNelze rozšifrovat soubor.\nSoubor nebyl nalezen.\nSoubor nelze načíst.\nPravděpodobně došlo k nekopletnímu přenosu.\nSoubor byl vytvořen novější verzí LOCKBASE a touto verzí jej nelze otevřít. K obdržení aktualizace kontaktujte svého dodavatele LOCKBASE.\nNeznámá chyba.
=IDP_B2B_RECV_UNPACKERR(2)	Soubor úspěšně rozbalen.\nDošlo k chybě během rozbalování souboru '%s':\nSoubor ještě nebyl otevřen.\nSoubor nebyl nalezen.\nSoubor nelze načíst.\nCílový soubor nelze zapsat.\nSoubor není dokument LOCKBASE.\nTento systémový soubor byl vytvořen novější verzí LOCKBASE a nelze jej otevřít touto verzí. K obdržení aktualizace kontaktujte svého dodavatele LOCKBASE.\nPeer-to-Peer partnerksý limit byl dosažen- nenlze otevřít soubor. Je potřeba licence nebo vymažte jednoho z existujících partnerů.\nNeznámá chyba.
=IDP_B2B_RECV_CLOSE(1)	Ještě nebyly rozbaleny všechny doručené soubory. Opravdu chcete opustit příchozí poštu?
=IDP_B2B_RECV_REVOKEDKEY(1)	Varování: Vyvolaný veřejný klíč byl použit k rozšifrování tohoto souboru.
=IDP_B2B_ADMIN_REM(1)	Pokud vymažete vizitku, již nikdy nebude možné odeslat soubory příslušnému příjemci.\n\nOpravdu chcete smazat vizitku '%s', vytvořenou v %s?
=IDP_B2B_ADMIN_REMREV(1)	Pokud vymažete vizitku, již nikdy nebude možné otevřít soubory, zašifrované příslušným uživatelem.\n\nOpravdu chcete smazat vyvolanou vizitku %s, vytvořenou v %s?
=IDS_LANGUAGE(1)	z

=IDP_APP_ERR_SDB(1)	Chyba během otevírání systémové databáze LOCKBASE (Lbw.sdb).
=IDP_APP_ERR_CTDBSCAN(1)	Chyba během načítání souboru typ vložky '%s', řádku %d, sloupce %d\r\rNačítání bylo přerušeno.
=IDP_APP_ERR_MODULE(1)	Soubor '%s' není umístěn v adresáři LOCKBASE, byl poškozen nebo chybí některá z jeho částí.
=IDS_APP_CFG_LBFCREATOR(1)	0|SMK%u|MK|GMK

=IDD_CGA(1)	Správa kódové skupiny
=IDD_CGA_STATICTXT1(1)	&Najít v:
=IDD_CGA_STATICTXT2(1)	Kódová &Skupina / Status:
=IDD_CGA_STATICTXT3(1)	&Popis:
=IDD_CGA_STATICTXT4(1)	U&žívaný:
=IDD_CGA_TAKEOVER(1)	&Obsadit\n&Uvolnit
=IDD_CGA_CANCEL(1)	&Zavřít

=IDD_CGASPLIT(1)	Rozdělení kódové skupiny
=IDD_CGASPLIT_STATICTXT1(1)	Tato kódová skupina může být rozdělena několika různými způsoby.\nVyberte jednu z metod uvedených níže k rozdělení vybrané kódové skupiny.
=IDD_CGASPLIT_STATIC_POS2SPLIT(1)	Zadejte požadovaný &režim pro každou pozici.
=IDD_CGASPLIT_STATIC_HINT(1)	(P = pevné, V = variabilní)

=IDD_CGA_EDITPROF(1)	Název profilu
=IDD_CGA_EDITPROF_STATICTXT1(1)	Zadejte popis profilu níže.
=IDD_CGA_EDITPROF_OK(1)	Potvrdit
=IDD_CGA_EDITPROF_CANCEL(1)	Zrušit

=IDS_CGA_NEW(1)	<Nový>\n<Přidat nový profil>
=IDS_CGA_HEADLINE(1)	Kódová skupina\nPopis
=IDP_CGA_NOSPLIT(1)	Vybranou kódovou skupinu nelze dále rozdělit.
=IDS_CGA_STATE(1)	Dostupný\nPoužíván\nRozdělit\nPoužíván\nUzamčen\nNový\nUzamčen síťí
=IDS_CGA_USAGE(1)	Systém\nPopis
=IDP_CGA_CGNOTFOUND(1)	Následující kódové skupiny nebyly nalezeny:\r%s.\r\rK vytvoření dostupných kódových skupin musí být základní kódová(é) skupina(y) rozdělena.
=IDP_CGA_COMBINE(1)	Vybrané kódové skupiny mohou být kombinovány s již použitou nebo mohou být přepsány.\r\rchcete kombinovat novou kódovou skupinu s již použitou?
=IDP_CGA_WARNMULTI(1)	Následující kódové skupiny jsou uzamčeny nebo již používány jiným systémem generálního klíče :\n
=IDP_CGA_REMOVE_OLD(1)	Systém '%s'vloženou kódovou skupinu. Chcete smazat existující vazby?
=IDP_CGA_WARN(1)	%s%s\rJe důrazně doporučeno opakovaně nepoužívat již použitou kódovou skupinu, jelikož toto může způsobit nekontrolovaný přístup klíčů z jiného systému.\r\rChcete kdykoliv opakovaně použít kódovou skupinu?
=IDP_CGA_WARNSINGLE(1)	Tato kódová skupina je již používána nejméně jedním systémem generálního klíče.\n
=IDP_CGA_ERRLOGIN(1)	Selhání přístupu ke Správě kódové skupiny:\rModul je právě blokován jiným uživatelem v síti.
=IDP_APPLIC_DDEONLY(1)	Nelze spojit Správu kódové skupiny s LOCKBASE.\nProgram bude ukončen.
=IDP_APPLIC_NOFAB(1)	Soubor specifikací značky '%s' nelze otevřít nebo obsahuje neplatná data. Správu kódové skupiny nelze spustit.
=IDP_APPLIC_DBERR(1)	Došlo k chybě během otevírání Správy kódové skupiny:\nSoubor '%s' nebyl nalezen.\nSoubor '%s' obsahuje neplatná data.\nSoubor '%s' nelze vytvořit.\nSoubor '%s' již existuje.\nSoubor '%s' je již otevřen.\nSpráva kódové skupiny je blokována jiným uživatelem v síti.\nSoubor '%s' byl vytvořen dřívější verzí LOCKBASE.\nSoubor '%s' byl vytvořen novější verzí LOCKBASE.
=IDS_CGA_LOCK(1)	Uzamknout / Odemknout kódovou skupinu (F7)
=IDS_CGA_EDIT(1)	Přidat / Upravit název profilu (F8)
=IDS_CGA_UP(1)	Pohyb o jednu úroveň nahoru (Ctrl+PgUp)
=IDS_CGA_SPLIT(1)	Rozdělit vybranou kódovou skupinu (F5)
=IDS_CGA_MERGE(1)	Sloučit dříve rozdělenou kódovou skupinu (F6)
=IDS_CGA_SHORT(1)	Souhrnné zobrazení (F3)
=IDS_CGA_DETAILED(1)	Detailní zobrazení (F4)
=IDS_CGASPLIT(2)	P&rofily\n&Rovnost vzorců\n&Pevná stavítka:(P = pevné, V = variabilní)\n&Boční stavítka:(P = pevné, V = variabilní):&Použijte více stavítek\n&2- nebo 3-kroky růstu:(2 = 2-kroky, 3 = 3-kroky, V = variabilní)\n&Nadřazená část profilů\nP&odřazená část profilů\n&Boční stavítka:(P = pevné, V = variabilní)\n&Magnety:(P = pevné, V = variabilní)\nP&rofily:(P = pevné, V = variabilní)
=IDP_CGAEDITPROF_EXISTS(1)	Profil s vybraným názvem již existuje.\nVyberte jiný název pro tento profil, prosím.
=IDP_CGAEDITPROF_DELETE(1)	Chcete smazat tento profil?
=IDS_CGAEDITPROF_DESCRIPTION(1)	<Uživatelsky definované profily>
=IDP_CGAEDITPROF_INVALID(1)	Vybraný název je neplatný.\nVyberte jiný název pro tento profil, prosím.
=IDP_STDBRAND_NODATA(1)	Žádné profily nejsou dostupné pro modul značky '%s'.
=AFX_IDS_APP_TITLE_CGA(1)	Správa kódové skupiny

=IDD_MAIN(1)	LOCKBASE Asistent vytvoření
=IDD_MAIN_PANEL_SYS(1)	Systém Hlavička
=IDD_MAIN_STATIC_100(1)	Objekt
=IDD_MAIN_STATIC_101(1)	&Číslo systému:
=IDD_MAIN_STATIC_102(1)	&Objekt/\nVlastník:
=IDD_MAIN_STATIC_103(1)	&Klient/\nDodavatel:
=IDD_MAIN_STATIC_104(1)	&Zákaznické číslo:
=IDD_MAIN_STATIC_105(1)	Typ Systému
=IDD_MAIN_STATIC_106(1)	Z&načka:
=IDD_MAIN_STATIC_107(1)	Z&působ výroby:
=IDD_MAIN_STATIC_108(1)	P&rofil/Kódová skupina:
=IDD_MAIN_STATIC_109(1)	Rozsah systému
=IDD_MAIN_STATIC_110(1)	Počet &generálních a skupinových klíčů:
=IDD_MAIN_STATIC_111(1)	Počet &Dveří/Vložek:
=IDD_MAIN_PANEL_CYL(1)	Dveře a Vložky
=IDD_MAIN_STATIC_200(1)	&Dveře/Místnost:
=IDD_MAIN_STATIC_201(1)	Budova/Místnost
=IDD_MAIN_STATIC_202(1)	&Budova:
=IDD_MAIN_STATIC_203(1)	&Místnost/Dveře:
=IDD_MAIN_STATIC_204(1)	Uzamykán
=IDD_MAIN_CHECK_CYL_MYKEY(1)	&Příslušné klíče:
=IDD_MAIN_STATIC_205(1)	K&opie
=IDD_MAIN_CHECK_CYL_CENTRAL(1)	C&entrálně uzamykané:
=IDD_MAIN_STATIC_206(1)	&Uzamykané stejně:
=IDD_MAIN_STATIC_207(1)	Vložka
=IDD_MAIN_STATIC_208(1)	T&yp:
=IDD_MAIN_STATIC_209(1)	&Zvláštní úpravy:
=IDD_MAIN_STATIC_210(1)	V&nější délka:
=IDD_MAIN_STATIC_211(1)	&Vnitřní délka:
=IDD_MAIN_STATIC_212(1)	&Povrch:
=IDD_MAIN_STATIC_213(1)	&Množství:
=IDD_MAIN_PANEL_SKEY(1)	Generální a skupinové klíče
=IDD_MAIN_STATIC_300(1)	&Generální/Skupinové:
=IDD_MAIN_STATIC_301(1)	Generální/skupinové klíče
=IDD_MAIN_STATIC_302(1)	&Popis:
=IDD_MAIN_STATIC_303(1)	&Množství:
=IDD_MAIN_STATIC_304(1)	Uzamykán
=IDD_MAIN_STATIC_305(1)	&Otevírá dveře/Místnost:
=IDD_MAIN_STATIC_306(1)	&Neotvírá:
=IDD_MAIN_PANEL_CCYL(1)	Centrálně uzamykané
=IDD_MAIN_STATIC_400(1)	&Centrálně uzamykané:
=IDD_MAIN_STATIC_404(1)	Centrálně uzamykané:
=IDD_MAIN_STATIC_401(1)	Uzamykán
=IDD_MAIN_STATIC_402(1)	&Otevírán:
=IDD_MAIN_STATIC_403(1)	&Neotvírán:
=IDD_MAIN_PANEL_FIN(1)	Závěrečná zpráva
=IDD_MAIN_STATIC_500(1)	Systém generálního klíče byl kompletně nastaven.
=IDD_MAIN_STATIC_FIN(1)	Zkontrolujte zadání na základě následujících zpráv. Pokud všechna data splnila vaše očekávání, stiskněte tlačítko  'Dokončit' k vytvoření systému.
=IDD_MAIN_STATIC_FIN_C2B(1)	Zkontrolujte zadání na základě následujících zpráv. Stiskněte 'Tisk...' k vytištění schématu systému. Použijte 'Objednat...' k odeslání dat jako objednávky přes internet. Po 'Ukončit' zavřete program.
=IDD_MAIN_STATIC_502(1)	Pokud je třeba provést změny, použijte tlačítko '<< Zpět' k otevření příslušné vstupní masky, která dovolí provést požadované změny.
=IDD_MAIN_STATIC_503(1)	Typ Systému:\n\nPočet funkcí vložek:\n... z nich je Centrálně uzamykaných:\n\npočet vložek:\n\nGenerální klíč:\nPočet skupinových klíčů:\nPočet příslušných klíčů:\n\nPočet kopií klíčů:
=IDD_MAIN_STATIC_FIN_REPORT(1)	%S\n\n%CF\n%CC\n\n%CN\n\n%MK\n%KF\n%CK\n\n%KN
=IDD_MAIN_BUTTON_PRINT(1)	&Tisk...
=IDD_MAIN_BUTTON_SEND(1)	&Objednat...
=IDD_MAIN_BUTTON_ROLLBACK(1)	&Zpět
=IDD_MAIN_BUTTON_BACK(1)	<< &Zpět
=IDD_MAIN_BUTTON_NEXT(1)	&Dále >>|&Dokončit
=IDD_MAIN_OK(1)	&Použít

=IDD_CTDB_EXTRA(1)	Zvláštní úpravy
=IDD_CTDB_EXTRA_LIST_MAIN(1)	Zkrácený název\tPopis
=IDD_CTDB_EXTRA_STATICTXT1(1)	Stiskněte <CTRL> pro vícenásobný výběr
=IDD_CTDB_EXTRA_STATIC_HELP(1)	Toto příslušenství musí být specifikováno více detailně. Vyberte jednu z hodnot níže, prosím:
=IDD_CTDB_EXTRA_LIST_ATTR(1)	Hodnota\tPopis
=IDD_CTDB_EXTRA_OK(1)	Potvrdit

=IDP_MSG_DIGITAL(1)	Zadejte kladné číslo.
=IDP_MSG_ABORT(1)	Pokud zavřete Asistenta nyní,nebude vytvořen žádný systém a všechna vložená data budou ztracena.\n\nOpravdu chcete zavřít Asistenta?
=IDP_MSG_CLOSE(1)	Opravdu chcete zavřít Asistenta?
=IDP_MSG_INVEXTRA(1)	Zvláštní úprava '%s' není platná.
=AFX_IDS_APP_TITLE_Creator(1)	LOCKBASE Asistent vytvoření
=IDS_HLP_BTNUP(1)	Toto tlačítko použijte k posunutí nahoru z vybraného řádku o jednu pozici.
=IDS_HLP_BTNDN(1)	Toto tlačítko použijte k posunutí dolu z vybraného řádku o jednu pozici.
=IDS_HLP_BTNABORT(1)	Stiskněte toto tlačítko kolikrát je třeba ke zrušení posledních změn v polích vybraných záznamů.
=IDS_HLP_BTNAPPLY(1)	Stiskněte toto tlačítko kolikrát je třeba k použití posledních změn v polích vybraných záznamů.
=IDS_HLP_BTNBACK(1)	Použijte toto tlačítko k návratu předchozí vstupní masky.
=IDS_HLP_BTNNEXT(1)	Použijte toto tlačítko k ukončení vkládání dat v této masce a přechodu do další masky.
=IDS_HLP_PGSYS(1)	v této vstupní masce specifikujte základní parametry systému generálního klíče. Data zde vložená jsou použita k vytvoření Systému Hlavička a udávají velikost systému.
=IDS_HLP_SYSNMB(1)	Zde zadejte Číslo systému.
=IDS_HLP_SYSOWNER(1)	Zde zadejte adresu objektu, kde bude systém využíván. Můžete použít klávesu <Enter> k vložení dalších řádků pro text.
=IDS_HLP_SYSSUP(1)	Zde zadejte adresu klienta nebo dodavatele, který bude systém spravovat (případně vlastní). Můžete použít klávesu <Enter> k vložení dalších řádků pro text.
=IDS_HLP_SYSCUSTN(1)	Zde zadejte Zákaznické číslo, pokud jej znáte.
=IDS_HLP_SYSBRAND(1)	Zde vyberte značku, ze které má být systém vyroben.
=IDS_HLP_SYSPROD(1)	Zde specifikujte, jak vyrobit systém:\n\nTovární systém: Systém bude kalkulován a smontován v továrně\n\nTovárna smontuje systém: Systém bude kalkulován použitím zákaznického profilu, ale smontován továrnou\n\nPouze kalkulace: Systém bude kalkulován použitím zákaznického profilu. Nicméně, nebude smontován továrnou ale vámi.
=IDS_HLP_SYSPROF(1)	Zde zadejte zákaznický profil a/nebo kódovou skupinu, která má být použita pro kalkulaci systému. to je nezbytné pouze pro továrnou smontovaný a kalkulovaný systém.
=IDS_HLP_SYSKEY(1)	Zde zadejte počet nadřazených klíčových funkcí, tj. počet požadovaných generálních a skupinových klíčů.\n\nPokud je požadován pouze generální klíč ale žádné skupinové, zadejte '1'.
=IDS_HLP_SYSCYL(1)	Zde zadejte počet požadovaných vložek a/nebo dveří.
=IDS_HLP_PGCYL(1)	v této vstupní masce jsou zadávána data pro vložky a/nebo dveře. Každá vložka je uspořádána na jeden řádek v seznamu. Při vícenásobném výběru můžete pracovat s různými vložkami v jednom kroku. Pole s různými obsahy jsou označena hvězdičkou (*). Ponechte hvězdičku (nebo zadejte znova), pokud chcete nechat příslušná pole beze změn.
=IDS_HLP_CYLLIST(1)	Zde vyberte záznamy, které mají být změněny. K výběru několika datových záznamů, přidržte klávesu <Ctrl> a klikejte na požadované řádky. Můžete použít klávesu <Shift>  k výběru většího rozsahu záznamů.
=IDS_HLP_CYLBUILD(1)	Zde zadejte budovu, kde je umístěna místnost nebo dveře.
=IDS_HLP_CYLDOOR(1)	Zde zadejte název místnosti a/nebo dveří, kde má být vložka instalována. Použijte '@' k vložení pořadových čísel. Číslo přímo za symbolem specifikuje výchozí hodnotu číslování.
=IDS_HLP_CYLMY(1)	Aktivujte tento kontrolní rámeček, pokud vložky mají mít příslušné klíče. Počet kopií klíče mohou být specifikovány v poli 'Kopie'.\n\nPříslušné klíče otevřou pouze jejich vlastní vložku. Přesto  příslušné klíče mohou otvírat také centrální vložku.
=IDS_HLP_CYLMYCNT(1)	Zde zadejte počet kopií příslušných klíčů.\n\nPříslušné klíče otevřou pouze jejich vlastní vložku. Přesto  příslušné klíče mohou otvírat také centrální vložku.
=IDS_HLP_CYLCC(1)	Aktivujte tento kontrolní rámeček pokud vybrané vložky mají být centrálně uzamykány. To je nezbytné, pokud příslušné klíče jiných vložek mají také otvírat tuto vložku (např. v případě hlavního vstupu).
=IDS_HLP_CYLQTY(1)	V tomto poli můžete měnit množství vybraných vložek. Nicméně se to nedoporučuje. Tato funkce se používá k nastavení počtu 0 pro vložky, které nemají být dodány nyní.
=IDS_HLP_CYLALIKE(1)	Pokud vybrané vložky mají být uzamykané stejně jako další vložka, můžete tuto vložku vybrat zde. Uzamykání (generálním a skupinovými klíči) je načteno z vybraného 'otce'. Toto má příznivý vliv na snížení počtu specifikovaných vložek a pravděpodobně špatných záznamů.
=IDS_HLP_CYLTYPE(1)	Zde zadejte typ vložky. Části typu číslování položek nebo popis vložek. Následovně v roletové nabídce najdete odpovídající vstupní položky. Po výběru požadovaných položek se zpřístupní další pole ke specifikaci typu vložky (Zvláštní úpravy, délka, povrch).
=IDS_HLP_CYLEXTRA(1)	Zde jsou zobrazeny vybrané zvláštní úpravy vložek. Pro výběr zvláštních úprav klikněte na pravé tlačítko vedle pole ('>').
=IDS_HLP_CYLOUT(1)	Zde vyberte délku vnější strany vložky.
=IDS_HLP_CYLIN(1)	zde vyberte vnitřní stranu vložky.
=IDS_HLP_CYLFIN(1)	Zde vyberte povrchovou úpravu vložky.
=IDS_HLP_PGKEY(1)	V této vstupní masce jsou zadávána data pro nadřazené klíče. Nadřazené klíče jsou klíče generální a skupinové.\n\n Každý klíč je uspořádán na jednom řádku. Při vícenásobném výběru můžete pracovat s několika klíči v jednom kroku. Pole s rozdílnými obsahy jsou označena hvězdičkou (*). Ponechte hvězdičku (nebo zadejte znova), pokud chcete nechat příslušná pole beze změn.
=IDS_HLP_KEYLIST(1)	Zde vyberte záznamy jež mají být změněny. K výběru několika datových záznamů, přidržte klávesu <Ctrl> a klikejte na požadované řádky. Můžete použít klávesu <Shift>  k výběru většího rozsahu záznamů.
=IDS_HLP_KEYDESC(1)	Zde zadejte popis nadřazených klíčů (např. 'Generální klíč', 'Skupinový klíč správce', atd.). Použijte '@' k vložení pořadových čísel. Číslo přímo za symbolem specifikuje výchozí hodnotu číslování.
=IDS_HLP_KEYQTY(1)	Zde zadejte požadovaný počet kopií klíčů pro vybrané klíče.
=IDS_HLP_KEYLNK(1)	Do tohoto seznamu musíte přetáhnout vložky, jež mají být otevírány vybranými nadřazenými klíči. To uděláte tak, že vyberete požadované vložky v pravém seznamu a poté stisknete tlačítko  '<-'.
=IDS_HLP_KEYUNLNK(1)	Do tohoto seznamu musíte přetáhnout vložky, jež nemají být otevírány vybranými nadřazenými klíči. To uděláte tak, že vyberete požadované vložky v levém seznamu a poté stisknete tlačítko '->'.
=IDS_HLP_KEYBTNLT(1)	Toto tlačítko použijte k přesunu vybraných záznamů z pravého do levého seznamu. Tímto specifikujete, že tyto vložky jsou otevírány nadřazenými klíči.
=IDS_HLP_KEYBTNRT(1)	Toto tlačítko použijte k přesunu vybraných záznamů z levého do pravého seznamu. Tímto specifikujete, že tyto vložky nejsou otevírány nadřazenými klíči.
=IDS_HLP_PGCC(1)	V této vstupní masce můžete definovat uzamykání centrálních vložek.\n\nCentrální vložky jsou ty, jež jsou otevírány nadřazenými klíči, jejich příslušnými ale i příslušnými klíči ostatních vložek.\n\nPro každou vložku v seznamu je k dispozici jeden řádek. Při vícenásobném výběru můžete pracovat s několika vložkami v jednom kroku.\n\nPožadovaná uzamykání se specifikují přesunem odpovídajících příslušných klíčů ze seznamu z pravé poloviny do levé.
=IDS_HLP_CCLIST(1)	Zde vyberte záznamy jež mají být změněny. K výběru několika datových záznamů, přidržte klávesu <Ctrl> a klikejte na požadované řádky. Můžete použít klávesu <Shift>  k výběru většího rozsahu záznamů.
=IDS_HLP_CCNAME(1)	V tomto poli budou zobrazena popisy vybraných centrálních vložek. Pokud jsou vybrány rozdílné záznamy,jsou označeny (*) hvězdičkou.
=IDS_HLP_CCLNK(1)	Do tohoto seznamu musíte přetáhnout příslušné klíče, jež mají otevírat vybrané centrální vložky. To uděláte tak, že vyberete požadované klíče v pravém seznamu,a stisknete tlačítko '<-'.
=IDS_HLP_CCUNLNK(1)	Do tohoto seznamu musíte přetáhnout příslušné klíče, jež nemají otevírat vybrané centrální vložky. To uděláte tak, že vyberete požadované klíče v pravém seznamu,a stisknete tlačítko '->'.
=IDS_HLP_CCBTNLT(1)	Toto tlačítko použijte k přesunu vybraných záznamů z pravého do levého seznamu. Tímto specifikujete, že tyto příslušné klíče mohou otevírat vybrané centrální vložky.
=IDS_HLP_CCBTNRT(1)	Toto tlačítko použijte k přesunu vybraných záznamů z levého do pravého seznamu. Tímto specifikujete, že tyto příslušné klíče nemohou otevírat vybrané centrální vložky.
=IDS_HLP_PGFIN(1)	S pomocí této závěrečné zprávy můžete ověřit, zda byl systém nastaven správně a je kompletní.\n\nDůležité je rozlišení uzamykání (generálního/skupinových klíčů, funkce vložek, centrálních vložek a příslušných klíčů) a klíčů a/nebo vložek (kopie klíčů a vložek). Zatímco uzamykaní představuje logické funkce klíče a/nebo vložky, kopie klíčů a vložek jsou hmotné jednotky jednotlivých vložek a klíčů.
=IDS_HLP_FINREP(1)	Bude vytvořena statistiky některých vámi zadaných dat systému. Ty vám mohou pomoci snadněji odhalit chybná zadání.
=IDS_HLP_BTNFINISH(1)	Stiskněte toto tlačítko k ukončení vkládání a ke spuštění vytvoření souboru systému generálního klíče.\n\nOvěřte, prosím, správnost a kompletnost vašeho zadání, předtím, než soubor začnete vytvářet.
=IDS_HLP_CYLBTNEXTRA(1)	Zde klikněte pro výběr zvláštních úprav vložek. Můžete kombinovat různé zvláštní úpravy, dokud to bude technicky možné.
=IDS_HLP_BTNFINISH_C2B(1)	Stiskněte toto tlačítko pro ukončení programu.
=IDS_HLP_FINBTNPRINT(1)	Stiskněte toto tlačítko l vytištění schéma systému generálního klíče.
=IDS_HLP_FINBTNSEND(1)	Stiskněte toto tlačítko k odeslání dat jako objednávky přes internet.
=IDS_HLP_CYLTYPE_1(1)	Zde zadejte typ vložek.
=IDS_HLP_CYLEXTRA_1(1)	Zde zadejte zvláštní úpravy vložek.
=IDS_HLP_CYLOUT_1(1)	Zde zadejte vnější délku vložek.
=IDS_HLP_CYLIN_1(1)	Zde zadejte vnitřní délku vložek.
=IDS_MSG_LOCTXT(1)	Dveře|Skupina|1|3|<Ne>|Jednoduché změny|Systém generálního klíče|Systém centrální vložky|GK/CV systém|SGK systém|SGK/CV systém|Ano|Ne|e|Tovární systém\nTovárnou smontovaný systém\nKalkulovat pouze\n
=IDS_MSG_LOCTXT_PFAFF(1)	Dveře|Skupina|1|3|<Ne>|Jednoduché změny|Systém generálního klíče|Systém centrální vložky|Systém generálního klíče|SGK systém|SGK systém|Ano|Ne|e|Tovární systém\nTovárnou smontovný systém\nKalkulovat pouze
=IDS_HLP_CYLFIN_1(1)	Zde zadejte povrchovou úpravu vložky.
=IDS_HLP_CYLCODE(1)	Zde zadejte item code vložek.
=AFX_IDS_APP_TITLE_CTDB(1)		LOCKBASE VLožka Typ Database 
=BRANDS_GERA_ISEOCSR_T0(0)		Aktivace omezení pro hloubku 5
=IDD_B2B_ADMIN_BTN_IMPORT(0)		&Import...
=IDD_CFG_LOADFORMAT(1)		Nastavení Formát ŠablonA
=IDD_CFG_LOADFORMAT_582(1)		Nekopírovat\nPouze pokud je pole prázdné\nVždy kopírovat
=IDD_CFG_LOADFORMAT_584(1)		Nekopírovat\nPouze pokud je pole prázdné\nVždy kopírovat
=IDD_CFG_LOADFORMAT_748(1)		Nekopírovat\nPouze pokud je pole prázdné\nVždy kopírovat
=IDD_CFG_LOADFORMAT_751(1)		Nekopírovat\nPouze pokud je pole prázdné\nVždy kopírovat
=IDD_CFG_LOADFORMAT_752(1)		Nekopírovat\nKopírovat
=IDD_CFG_LOADFORMAT_754(1)		Nekopírovat\npouze pokud je pole prázdné\nvždy kopírovat
=IDD_CFG_LOADFORMAT_STATICTXT1(1)		Definujte datová pole v seznamu,která by měla být kopírována ze šablony:
=IDD_CYLINDER_STATICTXT13(1)		Funkce
=IDD_CYLINDER_STATICTXT14(1)		&Uzamykatelné jako:
=IDD_DOC_PASTE(1)		Vložit záznamy
=IDD_DOC_PASTE_691(1)		Nahradit\nvložit
=IDD_DOC_PASTE_692(1)		Ignorovat\nPřidat
=IDD_DOC_PASTE_693(2)		Čárka\nSředník\nTab\nMezera
=IDD_DOC_PASTE_CANCEL(1)		Zrušit
=IDD_DOC_PASTE_OK(1)		OK
=IDD_DOC_PASTE_STATICTXT1(1)		&Vložit mode:
=IDD_DOC_PASTE_STATICTXT3(1)		&Oddělovač sloupců:
=IDD_DOC_PASTE_STATICTXT4(1)		Jak vložit?
=IDD_DOC_SEARCH_EX_723(1)		Filtr\nVybrat
=IDD_EVVA_3KS_CANCEL(1)		Zrušit
=IDD_EVVA_3KS_OK(1)		OK
=IDD_EXCHG_CSVEDIT_691(1)		Datové pole\nSpojení
=IDD_EXCHG_CSVEDIT_725(1)		Matrix\nSeznam hodnot
=IDD_EXCHG_CSVEDIT_731(1)		Sloupec\nŘada
=IDD_EXCHG_CSVEDIT_732(1)		Sloupec\nŘada
=IDD_INSTALL_BUTTON_DESTBIN(0)		&Změna...
=IDD_INSTALL_BUTTON_DESTDATA(0)		Z&měna...
=IDD_LBWCTDB_DIALOG(1)		LOCKBASE Vložka Typ Database
=IDD_LBWCTDB_DIALOG_1094(1)		Vložka\nKlíč
=IDD_LBWCTDB_DIALOG_1104(1)		Mechanické\nMechatronické\nElektronické
=IDD_LBWCTDB_DIALOG_BTN_COPY(1)		&Kopírovat
=IDD_LBWCTDB_DIALOG_BTN_DEL(1)		&Smazat
=IDD_LBWCTDB_DIALOG_BTN_NEW(1)		&Nové
=IDD_LBWCTDB_DIALOG_BTN_PASTE(1)		&Vložit
=IDD_LBWCTDB_DIALOG_BTN_PUBLISH(1)		Z&veřejnit
=IDD_LBWCTDB_DIALOG_CDESC(1)		&Označení:
=IDD_LBWCTDB_DIALOG_CID(1)		&Sériové číslo:
=IDD_LBWCTDB_DIALOG_CLIST(1)		Sériové číslo\tOznačení
=IDD_LBWCTDB_DIALOG_CLOSE(1)		&Zavřít
=IDD_LBWCTDB_DIALOG_ELIST(1)		Zkratka\zOznačení
=IDD_LBWCTDB_DIALOG_ICOMP(1)		SL&ožka:
=IDD_LBWCTDB_DIALOG_ILIST(1)		Číslo položky\tOznačení
=IDD_LBWCTDB_DIALOG_ISTATE(1)		Po&ložka vypnuta:
=IDD_LBWCTDB_DIALOG_ITECH(1)		Tec&hnologie:
=IDD_LBWCTDB_DIALOG_LHLP1(0)		VLožte číslo licence (musí být unikátní), zákaznické číslo a seznam zákazníků zde, oddělené čárkou.
=IDD_LBWCTDB_DIALOG_LID(0)		&Číslo licence:
=IDD_LBWCTDB_DIALOG_LLIST(0)		Licence\tZákazník
=IDD_LBWCTDB_DIALOG_LNUM(0)		Č&íslo zákazníka:
=IDD_LBWCTDB_DIALOG_PGE(1)		Speciální úprava
=IDD_LBWCTDB_DIALOG_PGI(1)		Položka
=IDD_LBWCTDB_DIALOG_PGL(0)		Záznam Zákazník
=IDD_LBWCTDB_DIALOG_PGS(1)		Systém
=IDD_LBWCTDB_DIALOG_STATIC1(1)		&Zkratka:
=IDD_LBWCTDB_DIALOG_STATIC10(1)		&Speciální úprava:
=IDD_LBWCTDB_DIALOG_STATIC12(1)		Systém
=IDD_LBWCTDB_DIALOG_STATIC13(1)		Nejprve vložte číslo systému. Název zobrazený zákazníkovi bude kombinace výrobce + název systému, který zadáte" Např. 'Cisa' + 'C83'
=IDD_LBWCTDB_DIALOG_STATIC14(1)		'Vytvořit' nový systém.
=IDD_LBWCTDB_DIALOG_STATIC15(1)		Zkratky všech speciálních úprav, které jsou použitelné pro typ vložky (oddělené čárkou).
=IDD_LBWCTDB_DIALOG_STATIC16(1)		Zkratky všech položek, které nemohou být kombinované se speciální úpravou v jedné vložce.
=IDD_LBWCTDB_DIALOG_STATIC17(1)		Prvky výčtu jsou oddělené čárkou např. "Zlato, Stříbro, Bronze".
=IDD_LBWCTDB_DIALOG_STATIC18(1)		Vložte pouze interní název systému (např. 'C83'). Výrobní název bude přidán softwarem.
=IDD_LBWCTDB_DIALOG_STATIC2(1)		O&zančení:
=IDD_LBWCTDB_DIALOG_STATIC20(1)		Délka může být zadána jednotlivě nebo jako rozsah, odděleno čárkou.\nNapř. "26, 30-80:5"znamená délku jedné strany - 26 mm a druhé strany - 30 až 80 mm po 5ti mm.
=IDD_LBWCTDB_DIALOG_STATIC21(1)		Nezahrnuje následující\n&Vnější délka:
=IDD_LBWCTDB_DIALOG_STATIC22(1)		Nezahrnuje následující\nVnitřní dé&lka:
=IDD_LBWCTDB_DIALOG_STATIC23(1)		Délka může být zadána jednotlivě nebo jako rozsah, odděleno čárkou.\nNapř. "26, 30-80:5"znamená délku jedné strany - 26 mm a druhé strany - 30 až 80 mm po 5ti mm.
=IDD_LBWCTDB_DIALOG_STATIC24(1)		Nezahrnuje následující\n&Povrch:
=IDD_LBWCTDB_DIALOG_STATIC25(1)		T&řída:
=IDD_LBWCTDB_DIALOG_STATIC26(1)		&Hodnota:
=IDD_LBWCTDB_DIALOG_STATIC27(1)		D&okumentace (HTML):
=IDD_LBWCTDB_DIALOG_STATIC28(1)		D&okumentace
=IDD_LBWCTDB_DIALOG_STATIC29(1)		&Preferovaný modul pro kalkulaci:
=IDD_LBWCTDB_DIALOG_STATIC3(1)		Nezahrnuje následující\n&Speciální úpravy:
=IDD_LBWCTDB_DIALOG_STATIC30(1)		&Modul není povolen pro kalkulaci:
=IDD_LBWCTDB_DIALOG_STATIC31(1)		V 'Přednastavení kalkulace' můžete vložit jméno preferovaného modulu pro kalkulaci. Je také možné definovat modul, který není pro kalkulaci povolen.
=IDD_LBWCTDB_DIALOG_STATIC32(1)		'Vymazat' odstraní současná vybraná data z databáse. 
=IDD_LBWCTDB_DIALOG_STATIC33(1)		Přednastavení kalkulace
=IDD_LBWCTDB_DIALOG_STATIC34(1)		Náz&ev:
=IDD_LBWCTDB_DIALOG_STATIC35(1)		&Přidat data z:
=IDD_LBWCTDB_DIALOG_STATIC36(1)		Název,který zadáte, musí přesně odpovídat modulu, který používá kalkulátor. Více názvů oddělte čárkou. 
=IDD_LBWCTDB_DIALOG_STATIC37(1)		Pro vytvoření kombinovaného systému vložte seznam systému, který je použit jako další zdroj pro položky a speciální úpravy.
=IDD_LBWCTDB_DIALOG_STATIC38(1)		Označení položek a speciálních úprav musí být jedinečné.
=IDD_LBWCTDB_DIALOG_STATIC39(1)		&Ostatní nastavení:
=IDD_LBWCTDB_DIALOG_STATIC4(1)		Č&íslo položky:
=IDD_LBWCTDB_DIALOG_STATIC40(1)		&Obsahuje data z:
=IDD_LBWCTDB_DIALOG_STATIC41(1)		Typ systému
=IDD_LBWCTDB_DIALOG_STATIC44(1)		&Cena:
=IDD_LBWCTDB_DIALOG_STATIC5(1)		&Označení:
=IDD_LBWCTDB_DIALOG_STATIC6(1)		&Délka vnější:
=IDD_LBWCTDB_DIALOG_STATIC7(1)		Délka vn&itřní:
=IDD_LBWCTDB_DIALOG_STATIC8(1)		&Povrch:
=IDD_LBWCTDB_DIALOG_STATICTXT1(1)		S&ystém:
=IDD_LBWCTDB_DIALOG_STATICTXT2(1)		&Pozice:
=IDD_LBWCTDB_DIALOG_STATICTXT3(1)		&Jazyk:
=IDD_LBWCTDB_DIALOG_USER_TYPES(1)		Povolit vložení neznámého typu
=IDD_MTRX_SETUP_691(1)		Vložky - klíče\nEuro Matrix
=IDD_MTRX_SETUP_CANCEL(1)		Zrušit
=IDD_MTRX_SETUP_HELP(1)		&Nápověda
=IDD_MTRX_SETUP_OK(1)		OK
=IDD_MTRX_SETUP_STATICTXT1(1)		&Dispozice:
=IDD_MTRX_SETUP_STATICTXT3(1)		&Generální/Skupinový klíč:
=IDD_MTRX_SETUP_STATICTXT4(1)		Změna &klíče:
=IDD_MTRX_SETUP_STATICTXT5(1)		&Centrální vložka: 
=IDD_PFAFF_CANCEL(1)		Zrušit
=IDD_PFAFF_OK(1)		OK
=IDD_PFAFF_STATIC_FILTER(1)		&Filter:
=IDD_PFAFF_STATIC_N_KEYS(1)		K&opírovat
=IDD_PRINT_FORMAT_653(1)		levý\nstřední\npravý
=IDD_SETUP_CISA_CHECK_LESS_PINS(0)		&Použít nižší boční stavítka
=IDD_SETUP_GIULIANI_B_CANCEL(1)		Zrušit
=IDD_SETUP_GIULIANI_B_OK(1)		OK
=IDD_SETUP_HEITEC_416(1)		Vše\Mechanické\Mechatronické
=IDD_SETUP_HEITEC_CANCEL(1)		Zrušit
=IDD_SETUP_HEITEC_OK(1)		OK

=IDD_SETUP_JAT_CHECK_SERVICE(1)		&Výstup pro servis vložek:

=IDD_SETUP_SAPF_LABEL_STATICTXT1(1)		Štítky: 
=IDD_SETUP_SAPF_LABEL_STATICTXT2(1)		&Jazyk:
=IDD_SETUP_SAPF_LABEL_STATICTXT3(1)		&Formát:
=IDD_SYSHEAD_HIST_EDIT(1)		Upravit rozšíření/Objednávka
=IDD_SYSHEAD_HIST_EDIT_CANCEL(1)		Zrušit
=IDD_SYSHEAD_HIST_EDIT_HELP(1)		&Nápověda
=IDD_SYSHEAD_HIST_EDIT_OK(1)		OK
=IDD_SYSHEAD_HIST_EDIT_STATICTXT1(1)		Objednávka
=IDD_SYSHEAD_HIST_EDIT_STATICTXT2(1)		Zákazník
=IDD_SYSHEAD_HIST_EDIT_STATICTXT4(1)		Doručení
=IDD_SYSHEAD_HIST_EDIT_STATICTXT5(1)		Po&známky:
=IDD_SYSHEAD_HIST_EDIT_STATIC_11(1)		&Založeno:
=IDD_SYSHEAD_HIST_EDIT_STATIC_12(1)		&Ukončeno:
=IDD_SYSHEAD_HIST_EDIT_STATIC_13(1)		&Číslo objednávky:
=IDD_SYSHEAD_HIST_EDIT_STATIC_14(1)		Datum o&bjednávky:
=IDD_SYSHEAD_HIST_EDIT_STATIC_15(1)		Datum do&ručení:
=IDD_SYSHEAD_HIST_EDIT_STATIC_16(1)		Ex&pedice:
=IDD_SYSHEAD_HIST_EDIT_STATIC_18(1)		&Označení:
=IDD_SYSHEAD_HIST_EDIT_STATIC_19(1)		&Zákaznické číslo:
=IDD_SYSHEAD_HIST_EDIT_STATIC_21(1)		Z&ákazník:
=IDD_SYSHEAD_HIST_EDIT_STATIC_22(1)		Ko&ntakt:
=IDD_SYSHEAD_HIST_ORDER(1)		Správa objednávky
=IDD_SYSHEAD_HIST_ORDER_1018(1)		Klíče\nvložky 
=IDD_SYSHEAD_HIST_ORDER_BUTTON_STRFORM(1)		&Formát...
=IDD_SYSHEAD_HIST_ORDER_CANCEL(1)		Zrušit
=IDD_SYSHEAD_HIST_ORDER_CHECK2(1)		&Při přesunu vložek také změnit jejich klíče
=IDD_SYSHEAD_HIST_ORDER_HELP(1)		&Nápověda
=IDD_SYSHEAD_HIST_ORDER_OK(1)		OK
=IDD_SYSHEAD_HIST_ORDER_STATICTXT1(1)		Objednávka:
=IDD_SYSHEAD_HIST_ORDER_STATICTXT2(1)		Vyberte klíče a vložky k objednávce:
=IDD_SYSHEAD_HIST_ORDER_STATICTXT3(1)		&Seznam dat:
=IDD_SYSHEAD_HIST_ORDER_STATICTXT4(1)		Patřící k této objednávce:
=IDD_SYSHEAD_HIST_ORDER_STATICTXT5(1)		&Dostupné:
=IDD_SYSHEAD_SCARD(0)		Bezp&ečnostní karta:
=IDP_B2B_INF_FACTORY_BACKUP(1)		Soubor\n<%1>\nbyl přesunut do archivu 
=IDP_B2B_SETUP_FACTORYCARD(0)		Chyba při načítání výrobní karty pro tuto instalaci. Pravděpodobně se nelze připojit k internetu. Instalace se nezdařila.
=IDP_CISA_FILENAME_ERR(0)		Název složky '%1'se neshoduje s číslem systému '%2'.
=IDP_CNF_HTML(1)		Chcete vytvořit a zveřejnit HTML dokument pro databázi vložek?
=IDP_CNF_PUBLISH(1)		Pro odeslání dat budou nejprve údaje o zboží zapsána do místní složky. Poté s připojením na internet se přenese tato složka do Lockbase B2B server.\n\nPo přenosu složky budou nová data zpřístupněna zákazníkovi.\n\nChcete začít s publikaci?
=IDP_CNF_RECDEL(1)		Určitě chcete smazat vybraná data?
=IDP_CNF_RECPASTE(1)		Opravdu chcete vložit data ze schránky?
=IDP_CNF_SAVE(1)		Chcete uložit změny?
=IDP_CNF_SYSCOPY(1)		Opravdu chcete vytvořit kopii této položky?
=IDP_CNF_SYSDEL(1)		Opravdu chcete zcela odstranit tuto položku?
=IDP_CNF_UPLOAD(1)		Nyní se s připojením na internet přenese složka na server.\n\nOpravdu chcete pokračovat?
=IDP_DOC_EXCHG_PORTIER(0)		Chybí požadavaný štítek\nNeplatný obsah\nNeplatné, chyba
=IDP_DOC_MAKECYLFUNCMULTI(1)		Rozhodli jste se použít sériové číslo k definici funkci vložek('%s').\nJe to možné, ovšem často vede k neočekávaným (nezamýšleným) výsledkům.\n\nChcete přesto pokračovat?
=IDP_DOC_ORDER_CLOSE(1)		Následující objednávka bude uzavřena:\n\n%s k datu %s
=IDP_DOC_ORDER_CNF_CLOSE(0)		Objednávka je otevřena.\nChcete uzavřít?
=IDP_DOC_SYS_DELIVDATE(0)		Vložte datum doručení.
=IDP_ERR_CUSTLIC(0)		Číslo licence je neplatné.
=IDP_ERR_CYLLEN(1)		Vložená délka vložky je nesprávná.
=IDP_ERR_DB(1)		Není možné vytvořit další složku'%s'.\n\nProsím uzavřete programe tlačítkem 'Zavřít'.
=IDP_ERR_EXTDATA(1)		Externí zdroj dat neexistuje '%s' nebo nelze přečíst!
=IDP_ERR_HTML(1)		Vyskytla se chyba během kompilace HTML dokumentu\n\n%s\n\ndokument nebyl vytvořen.
=IDP_ERR_INET(1)		Spojení s Lockbase B2B server nebylo navázáno.\n\nPravděpodobně je připojení k internetu momentálně nedostupné.\n\nProces byl přerušen.
=IDP_ERR_NUM(1)		Prosím vložte kladnou celočíselnou hodnotu.
=IDP_ERR_PRINTIO(1)		Export souborů selhal.\n\nPravděpodobně nemáte dostatečná práva. Software potřebuje přístup pro zápis k instalační složce.\n\nProces byl přerušen.
=IDP_ERR_SYSTYPE(1)		Bylo zadáno příliš mnoho nebo málo popisů pro daný typ systému (kód).
=IDP_ERR_UNIQUE(1)		Tento název již existuje. Název musí být jedinečné.
=IDP_ERR_VIRTUAL(1)		Jeden nebo více z uvedených systému jsou neplatné.\n\nZákladní systém musí již existovat a musí být zadán přesně. Více systémů oddělte čárkou.
=IDP_INFO_PRINTIO(1)		Export složek byl úspěšně vytvořen.
=IDP_INFO_SUCCESS(1)		Databáze typů vložek byla úspěšně přenesena do Lockbase B2B server a nyní je dostupná pro zákazníka.
=IDS_CALC_SIDEPIN(0)		Stavítko na pozici %u v rozporu s bočním stavítkem.
=IDS_DOC_PROCVIEW_LBLIST(0)		Přestavba obsahu %s\nPřevod kódových znaků... (%d%%)
=IDS_LOC_LANGUAGE(1)		Němčina\nAngličtina\nFrancouština\nItalština\nŠpanělština
=IDS_LOC_NEW(1)		Nové
=IDS_STRFRM_ACCESSTABLE(0)		\n<S!>Název\nPopis
=IDS_STRFRM_CYLINDER_EXCHG(0)		Vnější délka\nvnitřní délka
=IDS_STRFRM_DEPARTMENT(0)		\n<S!>Název\nPopis
=IDS_STRFRM_LOCATION(0)		\n<S!>Název\n<S!>Popis
=ID_EDIT_COPY(1)		&Kopírovat\tCTRL+C
=ID_EDIT_COPY_LINE(1)		Kop&írovat\tCTRL+C
=ID_EDIT_PASTE(1)		&Vložit\tCTRL+V
=ID_EDIT_PASTE_LINE(1)		Vl&ožit\tCTRL+V
=ID_EDIT_SEARCH(1)		Hle&dat...\tCTRL+F
=ID_FILE_ORDERS_CLOSE(1)		&Uzavřít aktuální objednávku
=ID_FILE_ORDERS_NEW(1)		&Otevřít novou objednávku
=ID_FILE_ORDERS_VIEW(1)		&Přehled objednávek
=ID_OPTIONS_CYLGROUPS(1)		Vložka &skupina
=ID_OPTIONS_LANGUAGE(0)		&Jazyk
=ID_OPTIONS_LANGUAGE_TTI(0)		Vyberte jeden z jazyků pro jeho změnu v aplikaci\nVyberte jeden z jazyků pro jeho změnu v aplikaci
=ID_OPTIONS_LBT(1)		Formát Šablona...
=ID_OPTIONS_MTRX_SETUP(1)		Nastavení systému &Matrix...
=LBW_ACCESSASSIGN_R0(0)		Selhání
=LBW_ACCESSASSIGN_R2(0)		Opravcu chcete vymazat tento zápis?
=LBW_ACCESSASSIGN_T1(0)		&Oddělení/Držitel klíče/Klíč:
=LBW_ACCESSASSIGN_T2(0)		&Umístění/Dveře/Vložka:
=LBW_ACCESSASSIGN_T3(0)		&Přidat
=LBW_ACCESSASSIGN_T4(0)		&Odstranit
=LBW_ACCESSASSIGN_T5(0)		P&oužít
=LBW_ACCESSASSIGN_T7(0)		Oddělení/Držitel klíče/Klíč\tUmístění/Dveře/Vložka
=LBW_ACCESSTABLE_1002(0)		Týdenní přehled\nMěsíční přehled\nRoční přehled
=LBW_ACCESSTABLE_R1(0)		Prosím potvrďte odstranění kalendáře '%1'
=LBW_ACCESSTABLE_T0(0)		Přehled
=LBW_ACCESSTABLE_T1(0)		Upravit
=LBW_ACCESSTABLE_T10(0)		Od&stranit
=LBW_ACCESSTABLE_T2(0)		Jm&éno:
=LBW_ACCESSTABLE_T3(0)		Pop&is:
=LBW_ACCESSTABLE_T5(0)		&Vybrat kalendář:
=LBW_ACCESSTABLE_T6(0)		&Přístup odepřen
=LBW_ACCESSTABLE_T7(0)		&Dostupný kalendář:
=LBW_ACCESSTABLE_T8(0)		&Nové...
=LBW_ACCESSTABLE_T9(0)		&Upravit...
=LBW_CALENDAR(0)		Kalendář
=LBW_CALENDAR_1011(0)		Žádné\nDanní\nTýdenní\nMěsíční\nRoční
=LBW_CALENDAR_1015(0)		Neomezené\nDatum ukončení\nPevně stanovené číslo
=LBW_CALENDAR_B1(0)		&Nové
=LBW_CALENDAR_B2(0)		&Vymazat
=LBW_CALENDAR_B4(0)		&Importovat...
=LBW_CALENDAR_R0(0)		Den\nTýden\nMěsíc\nRok
=LBW_CALENDAR_R1(0)		Vyskytla se chyba během importování kalendáře:\n\n%1\n\nTato složka nemůže být použita.
=LBW_CALENDAR_R2(0)		Neznámé '%1'
=LBW_CALENDAR_R4(0)		Chyba stahované složky '%1'
=LBW_CALENDAR_R6(0)		Tato operace kompletně nahradí současný obsah kalendáře obsahem ze složky\n\nProsím potvrďte 
=LBW_CALENDAR_R7(0)		Potvrďte smazání '%1'
=LBW_CALENDAR_T0(0)		&Kalendář:
=LBW_CALENDAR_T13(0)		Čí&slo:
=LBW_CALENDAR_T14(0)		&Popis:
=LBW_CALENDAR_T2(0)		Upravit
=LBW_CALENDAR_T3(0)		&Přehled:
=LBW_CALENDAR_T4(0)		&Od:
=LBW_CALENDAR_T5(0)		&Do:
=LBW_CALENDAR_T6(0)		Pop&is:
=LBW_CALENDAR_T9(0)		Přehled\tPopis
=LBW_CYLGROUP_T4(1)		Čís&lo:
=LBW_CYLGROUP_T5(1)		&Popis:
=LBW_CYLGROUP_T6(1)		Změny:
=LBW_CYLGROUP_T7(1)		&Dostupné:
=LBW_CYLGROUP_T8(1)		&Plánované
=LBW_DEPARTMENT(0)		Oddělení
=LBW_DEPARTMENT_T0(0)		&Název:
=LBW_DEPARTMENT_T1(0)		&Popis:
=LBW_KEYFUNC_R0(0)		zadaný typ klíče je neznámý.\nChcete opravdu použít tento typ?
=LBW_LOCATION(0)		Umístění
=LBW_LOCATION_R0(0)		POdporované grafické soubory
=LBW_LOCATION_T0(0)		&Název:
=LBW_LOCATION_T1(0)		&Popis:
=LBW_LOCATION_T2(0)		Vyberte grafické soubory, které obsahují půdorysy(typu BMP, JPG,PNG,TIF,EPS,TGA,PCT,WMF nebo EMF).
=LBW_LOCATION_T3(0)		&Grafický soubor
=LBW_LOCATION_T4(0)		&Soubor...
=LBW_R6(0)		Upozornění: %1 ze %2 záznamů nemůže být přidán
=LBW_R7(0)		Upozornění: %1 ze %2 záznamů nemůže být upraven
=LBW_R8(0)		Upozornění: %1 ze %2 záznamů nemůže být odstraněn
=POPUP4(1)		&Tisk
=POPUP6(1)		S&práva objednávek
=R0(0)		<Nové>
=R1(0)		Pondělí\nÚterý\nStředa\nČtvrtek\nPátek\nSobota\nNeděle
=R2(0)		Leden\nÚnor\nBřezen\nDuben\nKvěten\nČerven\nČervenec\nSrpen\nZáří\nŘíjen\nListopad\nProsinec
=R3(0)		Po\nÚt\nStř\nČtv\nPá\nSo\nNe
=STP_INSTALL_R0(0)		Instalace nemohla být dokončena úspěšně.\nOpravdu chcete ukončit nastavení programu?
=STP_INSTALL_R1(0)		Cílový adresář neexistuje '%s'.\nChcete ho vytvořit?
=STP_INSTALL_R10(0)		Vyskytla se interní chyba.\nProsím kontaktujte Körtner & Muth GmbH in Hamburg,Germany pro podporu.
=STP_INSTALL_R11(0)		<Nová instalace>
=STP_INSTALL_R12(0)		Vyberte cílový adresář:
=STP_INSTALL_R4(0)		Cílový adresář '%s' nebyl vytvořen. Pravděpodobně chybí přístupová práva.
=STP_INSTALL_R6(0)		Není dostatek místa v cílovém adresáři '%s'.
=STP_INSTALL_R7(0)		Číslo licence a existující instalace jsou rozdílné. Vyberte jinou cílovou složku.
=STP_INSTALL_R8(0)		Instalace byla přerušena.
=STP_INSTALL_R9(0)		Požadovaný soubor '%s'neexistuje nebo je poškozen.\nInstalace nemůže pokračovat.
=STP_INSTALL_S_BIN(0)		Program adresář:
=STP_INSTALL_S_DATA(0)		Data adresář:
=STP_LIST(1)		Instalace adresář
=STP_R0(0)		Další>>|start|Zavřít
=STP_R1(0)		Lockbase|Lockbase|plánování, Kalkulace a administrace Systému generálního klíče
=STP_R2(0)		Chyba při zápisu do cílového adresáře '%s' Pravděpodobně chybí přístupová práva.
=STP_R3(0)		Existující instalace je v současnosti užívána (%s). K odinstalování či instalování je potřeba aby všichni uživatelé zavřeli program.
=STP_R4(0)		Chyba zápisu do registlu. Pravděpodobně chybí přístupová práva.
=STP_UNINSTALL_R0(0)		Odinstalování není dokončeno.\nOpravdu chcete ukončit nastavení?
